clave_entidad,nombre_entidad,clave_distrito,cabecera_distrital,clave_municipio,nombre_municipio,seccion,padron_hombres,padron_mujeres,padron_nobinario,padron_electoral,lista_hombres,lista_mujeres,lista_nobinario,lista_nominal
14,RESIDENTES EXTRANJERO,0,0,0,0,0,78259,66791,1,145051,39712,34576,1,74289
14,JALISCO,1,TEQUILA,3,AHUALULCO DE MERCADO,24,1152,1247,0,2399,1141,1236,0,2377
14,JALISCO,1,TEQUILA,3,AHUALULCO DE MERCADO,25,461,504,0,965,452,503,0,955
14,JALISCO,1,TEQUILA,3,AHUALULCO DE MERCADO,26,414,442,0,856,409,436,0,845
14,JALISCO,1,TEQUILA,3,AHUALULCO DE MERCADO,27,919,956,0,1875,909,948,0,1857
14,JALISCO,1,TEQUILA,3,AHUALULCO DE MERCADO,28,744,808,0,1552,735,797,0,1532
14,JALISCO,1,TEQUILA,3,AHUALULCO DE MERCADO,29,976,1077,0,2053,971,1072,0,2043
14,JALISCO,1,TEQUILA,3,AHUALULCO DE MERCADO,30,415,466,0,881,409,464,0,873
14,JALISCO,1,TEQUILA,3,AHUALULCO DE MERCADO,31,1489,1542,0,3031,1478,1531,0,3009
14,JALISCO,1,TEQUILA,3,AHUALULCO DE MERCADO,32,149,142,0,291,148,140,0,288
14,JALISCO,1,TEQUILA,3,AHUALULCO DE MERCADO,33,716,756,0,1472,711,749,0,1460
14,JALISCO,1,TEQUILA,3,AHUALULCO DE MERCADO,34,1056,1102,0,2158,1050,1093,0,2143
14,JALISCO,1,TEQUILA,3,AHUALULCO DE MERCADO,35,756,726,0,1482,748,720,0,1468
14,JALISCO,1,TEQUILA,5,AMATITAN,40,1541,1615,0,3156,1516,1593,0,3109
14,JALISCO,1,TEQUILA,5,AMATITAN,41,822,853,0,1675,812,846,0,1658
14,JALISCO,1,TEQUILA,5,AMATITAN,42,1348,1408,0,2756,1322,1390,0,2712
14,JALISCO,1,TEQUILA,5,AMATITAN,43,1448,1439,0,2887,1429,1416,0,2845
14,JALISCO,1,TEQUILA,5,AMATITAN,44,267,275,0,542,265,274,0,539
14,JALISCO,1,TEQUILA,5,AMATITAN,45,202,179,0,381,201,175,0,376
14,JALISCO,1,TEQUILA,5,AMATITAN,46,265,263,0,528,262,261,0,523
14,JALISCO,1,TEQUILA,5,AMATITAN,47,594,575,0,1169,587,568,0,1155
14,JALISCO,1,TEQUILA,6,AMECA,48,1426,1461,0,2887,1413,1442,0,2855
14,JALISCO,1,TEQUILA,6,AMECA,50,1061,1159,0,2220,1053,1146,0,2199
14,JALISCO,1,TEQUILA,6,AMECA,51,572,681,0,1253,568,673,0,1241
14,JALISCO,1,TEQUILA,6,AMECA,52,1556,1669,1,3226,1548,1659,1,3208
14,JALISCO,1,TEQUILA,6,AMECA,53,447,503,0,950,442,495,0,937
14,JALISCO,1,TEQUILA,6,AMECA,54,475,513,0,988,472,510,0,982
14,JALISCO,1,TEQUILA,6,AMECA,55,483,517,0,1000,482,515,0,997
14,JALISCO,1,TEQUILA,6,AMECA,56,1231,1381,0,2612,1216,1375,0,2591
14,JALISCO,1,TEQUILA,6,AMECA,57,620,692,0,1312,611,688,0,1299
14,JALISCO,1,TEQUILA,6,AMECA,58,368,403,1,772,362,399,1,762
14,JALISCO,1,TEQUILA,6,AMECA,59,380,445,0,825,379,441,0,820
14,JALISCO,1,TEQUILA,6,AMECA,60,329,306,0,635,326,303,0,629
14,JALISCO,1,TEQUILA,6,AMECA,61,510,532,0,1042,505,526,0,1031
14,JALISCO,1,TEQUILA,6,AMECA,62,819,866,0,1685,812,862,0,1674
14,JALISCO,1,TEQUILA,6,AMECA,63,921,988,0,1909,915,978,0,1893
14,JALISCO,1,TEQUILA,6,AMECA,64,743,781,0,1524,739,774,0,1513
14,JALISCO,1,TEQUILA,6,AMECA,65,584,681,0,1265,574,674,0,1248
14,JALISCO,1,TEQUILA,6,AMECA,66,656,698,0,1354,649,689,0,1338
14,JALISCO,1,TEQUILA,6,AMECA,69,1007,949,0,1956,1002,938,0,1940
14,JALISCO,1,TEQUILA,6,AMECA,70,561,621,0,1182,551,605,0,1156
14,JALISCO,1,TEQUILA,6,AMECA,71,600,660,0,1260,594,653,0,1247
14,JALISCO,1,TEQUILA,6,AMECA,72,1184,1283,0,2467,1173,1273,0,2446
14,JALISCO,1,TEQUILA,6,AMECA,73,258,241,0,499,255,237,0,492
14,JALISCO,1,TEQUILA,6,AMECA,74,159,157,0,316,157,156,0,313
14,JALISCO,1,TEQUILA,6,AMECA,75,398,364,0,762,397,361,0,758
14,JALISCO,1,TEQUILA,6,AMECA,76,558,568,0,1126,547,564,0,1111
14,JALISCO,1,TEQUILA,6,AMECA,77,498,527,0,1025,495,522,0,1017
14,JALISCO,1,TEQUILA,6,AMECA,78,435,439,0,874,429,437,0,866
14,JALISCO,1,TEQUILA,6,AMECA,79,556,599,0,1155,551,596,0,1147
14,JALISCO,1,TEQUILA,6,AMECA,80,797,850,0,1647,788,843,0,1631
14,JALISCO,1,TEQUILA,6,AMECA,81,549,557,0,1106,544,552,0,1096
14,JALISCO,1,TEQUILA,6,AMECA,82,127,134,0,261,124,134,0,258
14,JALISCO,1,TEQUILA,6,AMECA,84,443,428,0,871,441,426,0,867
14,JALISCO,1,TEQUILA,6,AMECA,85,479,446,0,925,471,440,0,911
14,JALISCO,1,TEQUILA,6,AMECA,86,138,152,0,290,138,151,0,289
14,JALISCO,1,TEQUILA,6,AMECA,87,512,562,0,1074,505,557,0,1062
14,JALISCO,1,TEQUILA,6,AMECA,88,370,366,0,736,367,363,0,730
14,JALISCO,1,TEQUILA,6,AMECA,89,333,346,0,679,330,343,0,673
14,JALISCO,1,TEQUILA,6,AMECA,90,244,227,0,471,244,226,0,470
14,JALISCO,1,TEQUILA,6,AMECA,91,592,567,0,1159,581,554,0,1135
14,JALISCO,1,TEQUILA,6,AMECA,92,73,70,0,143,71,70,0,141
14,JALISCO,1,TEQUILA,6,AMECA,93,215,199,0,414,209,193,0,402
14,JALISCO,1,TEQUILA,6,AMECA,3738,951,1017,0,1968,931,1000,0,1931
14,JALISCO,1,TEQUILA,6,AMECA,3739,940,974,0,1914,936,966,0,1902
14,JALISCO,1,TEQUILA,7,SAN JUANITO DE ESCOBEDO,94,886,937,0,1823,884,934,0,1818
14,JALISCO,1,TEQUILA,7,SAN JUANITO DE ESCOBEDO,95,757,798,0,1555,752,793,0,1545
14,JALISCO,1,TEQUILA,7,SAN JUANITO DE ESCOBEDO,96,618,604,0,1222,616,601,0,1217
14,JALISCO,1,TEQUILA,7,SAN JUANITO DE ESCOBEDO,97,383,385,0,768,381,383,0,764
14,JALISCO,1,TEQUILA,7,SAN JUANITO DE ESCOBEDO,98,354,349,0,703,352,347,0,699
14,JALISCO,1,TEQUILA,7,SAN JUANITO DE ESCOBEDO,99,144,129,0,273,144,128,0,272
14,JALISCO,1,TEQUILA,7,SAN JUANITO DE ESCOBEDO,100,278,289,0,567,276,287,0,563
14,JALISCO,1,TEQUILA,7,SAN JUANITO DE ESCOBEDO,101,444,441,0,885,437,438,0,875
14,JALISCO,1,TEQUILA,9,EL ARENAL,139,1566,1680,0,3246,1553,1665,0,3218
14,JALISCO,1,TEQUILA,9,EL ARENAL,140,1296,1459,0,2755,1283,1440,0,2723
14,JALISCO,1,TEQUILA,9,EL ARENAL,141,2909,3065,0,5974,2874,3035,0,5909
14,JALISCO,1,TEQUILA,9,EL ARENAL,142,1251,1330,0,2581,1244,1318,0,2562
14,JALISCO,1,TEQUILA,9,EL ARENAL,143,1062,1143,0,2205,1055,1138,0,2193
14,JALISCO,1,TEQUILA,19,BOLAÐOS,292,623,637,0,1260,618,637,0,1255
14,JALISCO,1,TEQUILA,19,BOLAÐOS,293,327,329,0,656,325,327,0,652
14,JALISCO,1,TEQUILA,19,BOLAÐOS,295,281,261,0,542,280,259,0,539
14,JALISCO,1,TEQUILA,19,BOLAÐOS,3874,1087,1306,0,2393,1077,1297,0,2374
14,JALISCO,1,TEQUILA,19,BOLAÐOS,3875,849,1022,0,1871,843,1019,0,1862
14,JALISCO,1,TEQUILA,26,COLOTLAN,411,1011,1042,0,2053,998,1027,0,2025
14,JALISCO,1,TEQUILA,26,COLOTLAN,412,244,217,0,461,241,216,0,457
14,JALISCO,1,TEQUILA,26,COLOTLAN,413,609,684,0,1293,599,675,0,1274
14,JALISCO,1,TEQUILA,26,COLOTLAN,414,968,1033,0,2001,945,1017,0,1962
14,JALISCO,1,TEQUILA,26,COLOTLAN,415,449,532,0,981,439,523,0,962
14,JALISCO,1,TEQUILA,26,COLOTLAN,416,417,475,0,892,412,465,0,877
14,JALISCO,1,TEQUILA,26,COLOTLAN,417,640,672,0,1312,629,661,0,1290
14,JALISCO,1,TEQUILA,26,COLOTLAN,418,775,852,0,1627,764,836,0,1600
14,JALISCO,1,TEQUILA,26,COLOTLAN,419,600,639,0,1239,589,628,0,1217
14,JALISCO,1,TEQUILA,26,COLOTLAN,420,999,1092,0,2091,981,1073,0,2054
14,JALISCO,1,TEQUILA,26,COLOTLAN,421,356,355,0,711,347,346,0,693
14,JALISCO,1,TEQUILA,26,COLOTLAN,423,125,109,0,234,121,106,0,227
14,JALISCO,1,TEQUILA,26,COLOTLAN,424,129,118,0,247,129,118,0,247
14,JALISCO,1,TEQUILA,26,COLOTLAN,425,419,432,0,851,408,427,0,835
14,JALISCO,1,TEQUILA,26,COLOTLAN,426,205,189,0,394,201,188,0,389
14,JALISCO,1,TEQUILA,32,CHIMALTITAN,476,571,556,0,1127,564,547,0,1111
14,JALISCO,1,TEQUILA,32,CHIMALTITAN,477,602,626,0,1228,594,619,0,1213
14,JALISCO,1,TEQUILA,32,CHIMALTITAN,478,140,138,0,278,138,138,0,276
14,JALISCO,1,TEQUILA,37,ETZATLAN,530,1168,1225,0,2393,1153,1213,0,2366
14,JALISCO,1,TEQUILA,37,ETZATLAN,531,1308,1405,0,2713,1297,1393,0,2690
14,JALISCO,1,TEQUILA,37,ETZATLAN,532,783,877,0,1660,776,870,0,1646
14,JALISCO,1,TEQUILA,37,ETZATLAN,533,647,710,0,1357,639,704,0,1343
14,JALISCO,1,TEQUILA,37,ETZATLAN,534,265,317,0,582,262,313,0,575
14,JALISCO,1,TEQUILA,37,ETZATLAN,535,532,605,0,1137,530,594,0,1124
14,JALISCO,1,TEQUILA,37,ETZATLAN,536,1016,1122,0,2138,1006,1105,0,2111
14,JALISCO,1,TEQUILA,37,ETZATLAN,537,399,394,0,793,397,388,0,785
14,JALISCO,1,TEQUILA,37,ETZATLAN,538,633,618,0,1251,632,617,0,1249
14,JALISCO,1,TEQUILA,37,ETZATLAN,539,886,890,0,1776,878,885,0,1763
14,JALISCO,1,TEQUILA,37,ETZATLAN,540,132,117,0,249,132,116,0,248
14,JALISCO,1,TEQUILA,42,HOSTOTIPAQUILLO,1549,459,491,0,950,456,489,0,945
14,JALISCO,1,TEQUILA,42,HOSTOTIPAQUILLO,1550,206,199,0,405,205,199,0,404
14,JALISCO,1,TEQUILA,42,HOSTOTIPAQUILLO,1551,241,288,0,529,239,286,0,525
14,JALISCO,1,TEQUILA,42,HOSTOTIPAQUILLO,1552,542,543,0,1085,539,540,0,1079
14,JALISCO,1,TEQUILA,42,HOSTOTIPAQUILLO,1553,704,701,0,1405,698,699,0,1397
14,JALISCO,1,TEQUILA,42,HOSTOTIPAQUILLO,1554,140,160,0,300,140,160,0,300
14,JALISCO,1,TEQUILA,42,HOSTOTIPAQUILLO,1556,132,128,0,260,132,128,0,260
14,JALISCO,1,TEQUILA,42,HOSTOTIPAQUILLO,1557,96,100,0,196,96,100,0,196
14,JALISCO,1,TEQUILA,42,HOSTOTIPAQUILLO,1558,410,327,0,737,407,325,0,732
14,JALISCO,1,TEQUILA,42,HOSTOTIPAQUILLO,1559,155,139,0,294,154,137,0,291
14,JALISCO,1,TEQUILA,42,HOSTOTIPAQUILLO,1560,352,352,0,704,351,348,0,699
14,JALISCO,1,TEQUILA,43,HUEJUCAR,1561,704,739,0,1443,685,717,0,1402
14,JALISCO,1,TEQUILA,43,HUEJUCAR,1562,755,804,0,1559,732,794,0,1526
14,JALISCO,1,TEQUILA,43,HUEJUCAR,1563,517,551,0,1068,506,536,0,1042
14,JALISCO,1,TEQUILA,43,HUEJUCAR,1564,488,507,0,995,477,499,0,976
14,JALISCO,1,TEQUILA,43,HUEJUCAR,1565,481,494,0,975,466,483,0,949
14,JALISCO,1,TEQUILA,44,HUEJUQUILLA EL ALTO,1566,741,852,0,1593,737,850,0,1587
14,JALISCO,1,TEQUILA,44,HUEJUQUILLA EL ALTO,1567,1206,1307,0,2513,1190,1299,0,2489
14,JALISCO,1,TEQUILA,44,HUEJUQUILLA EL ALTO,1568,675,832,0,1507,671,827,0,1498
14,JALISCO,1,TEQUILA,44,HUEJUQUILLA EL ALTO,1569,215,212,0,427,212,210,0,422
14,JALISCO,1,TEQUILA,44,HUEJUQUILLA EL ALTO,1570,116,108,0,224,116,108,0,224
14,JALISCO,1,TEQUILA,44,HUEJUQUILLA EL ALTO,1571,64,52,0,116,64,52,0,116
14,JALISCO,1,TEQUILA,44,HUEJUQUILLA EL ALTO,1572,589,614,0,1203,584,611,0,1195
14,JALISCO,1,TEQUILA,57,MAGDALENA,1782,694,743,0,1437,682,735,0,1417
14,JALISCO,1,TEQUILA,57,MAGDALENA,1783,667,730,0,1397,660,726,0,1386
14,JALISCO,1,TEQUILA,57,MAGDALENA,1784,2081,2150,0,4231,2051,2131,0,4182
14,JALISCO,1,TEQUILA,57,MAGDALENA,1785,1033,1081,0,2114,1018,1064,0,2082
14,JALISCO,1,TEQUILA,57,MAGDALENA,1786,484,598,0,1082,480,590,0,1070
14,JALISCO,1,TEQUILA,57,MAGDALENA,1787,761,821,0,1582,753,818,0,1571
14,JALISCO,1,TEQUILA,57,MAGDALENA,1788,538,563,0,1101,530,558,0,1088
14,JALISCO,1,TEQUILA,57,MAGDALENA,1789,559,569,0,1128,549,564,0,1113
14,JALISCO,1,TEQUILA,57,MAGDALENA,1790,400,391,0,791,396,383,0,779
14,JALISCO,1,TEQUILA,57,MAGDALENA,1791,644,656,0,1300,640,646,0,1286
14,JALISCO,1,TEQUILA,57,MAGDALENA,3663,227,218,0,445,225,216,0,441
14,JALISCO,1,TEQUILA,57,MAGDALENA,3664,89,82,0,171,88,81,0,169
14,JALISCO,1,TEQUILA,63,MEZQUITIC,1831,587,622,0,1209,571,606,0,1177
14,JALISCO,1,TEQUILA,63,MEZQUITIC,1832,474,508,0,982,463,500,0,963
14,JALISCO,1,TEQUILA,63,MEZQUITIC,1833,81,66,0,147,79,66,0,145
14,JALISCO,1,TEQUILA,63,MEZQUITIC,1834,216,186,0,402,211,181,0,392
14,JALISCO,1,TEQUILA,63,MEZQUITIC,1835,246,247,0,493,245,242,0,487
14,JALISCO,1,TEQUILA,63,MEZQUITIC,1837,1936,2321,0,4257,1908,2301,0,4209
14,JALISCO,1,TEQUILA,63,MEZQUITIC,1838,1258,1563,0,2821,1241,1551,0,2792
14,JALISCO,1,TEQUILA,63,MEZQUITIC,3876,113,133,0,246,111,131,0,242
14,JALISCO,1,TEQUILA,63,MEZQUITIC,3877,122,163,0,285,121,159,0,280
14,JALISCO,1,TEQUILA,63,MEZQUITIC,3878,1211,1449,0,2660,1192,1427,0,2619
14,JALISCO,1,TEQUILA,63,MEZQUITIC,3879,1101,1321,0,2422,1084,1303,0,2387
14,JALISCO,1,TEQUILA,73,SAN CRISTOBAL DE LA BARRANCA,2050,686,632,0,1318,682,628,0,1310
14,JALISCO,1,TEQUILA,73,SAN CRISTOBAL DE LA BARRANCA,2051,173,177,0,350,172,177,0,349
14,JALISCO,1,TEQUILA,73,SAN CRISTOBAL DE LA BARRANCA,2052,394,365,0,759,392,365,0,757
14,JALISCO,1,TEQUILA,73,SAN CRISTOBAL DE LA BARRANCA,2053,111,102,0,213,110,102,0,212
14,JALISCO,1,TEQUILA,73,SAN CRISTOBAL DE LA BARRANCA,2054,166,158,0,324,164,156,0,320
14,JALISCO,1,TEQUILA,77,SAN MARCOS,2107,759,722,0,1481,755,719,0,1474
14,JALISCO,1,TEQUILA,77,SAN MARCOS,2108,879,895,0,1774,876,887,0,1763
14,JALISCO,1,TEQUILA,78,SAN MARTIN DE BOLAÐOS,2110,428,471,0,899,428,469,0,897
14,JALISCO,1,TEQUILA,78,SAN MARTIN DE BOLAÐOS,2111,537,560,0,1097,535,558,0,1093
14,JALISCO,1,TEQUILA,78,SAN MARTIN DE BOLAÐOS,2112,136,103,0,239,136,103,0,239
14,JALISCO,1,TEQUILA,82,SANTA MARIA DE LOS ANGELES,2157,242,264,0,506,232,258,0,490
14,JALISCO,1,TEQUILA,82,SANTA MARIA DE LOS ANGELES,2158,598,633,0,1231,583,624,0,1207
14,JALISCO,1,TEQUILA,82,SANTA MARIA DE LOS ANGELES,2159,242,257,0,499,239,253,0,492
14,JALISCO,1,TEQUILA,82,SANTA MARIA DE LOS ANGELES,2160,461,445,0,906,453,437,0,890
14,JALISCO,1,TEQUILA,82,SANTA MARIA DE LOS ANGELES,2161,309,293,0,602,305,285,0,590
14,JALISCO,1,TEQUILA,84,TALA,2181,1850,1961,0,3811,1828,1940,0,3768
14,JALISCO,1,TEQUILA,84,TALA,2182,2263,2385,0,4648,2238,2363,0,4601
14,JALISCO,1,TEQUILA,84,TALA,2183,746,762,0,1508,737,755,0,1492
14,JALISCO,1,TEQUILA,84,TALA,2184,455,530,0,985,450,526,0,976
14,JALISCO,1,TEQUILA,84,TALA,2185,993,1106,0,2099,984,1102,0,2086
14,JALISCO,1,TEQUILA,84,TALA,2186,504,563,0,1067,502,555,0,1057
14,JALISCO,1,TEQUILA,84,TALA,2187,1254,1307,0,2561,1238,1292,0,2530
14,JALISCO,1,TEQUILA,84,TALA,2188,542,579,0,1121,537,574,0,1111
14,JALISCO,1,TEQUILA,84,TALA,2189,1066,1083,0,2149,1056,1072,0,2128
14,JALISCO,1,TEQUILA,84,TALA,2190,696,741,0,1437,690,737,0,1427
14,JALISCO,1,TEQUILA,84,TALA,2191,463,559,0,1022,460,545,0,1005
14,JALISCO,1,TEQUILA,84,TALA,2192,306,339,0,645,302,335,0,637
14,JALISCO,1,TEQUILA,84,TALA,2193,548,652,0,1200,539,648,0,1187
14,JALISCO,1,TEQUILA,84,TALA,2194,910,913,0,1823,900,906,0,1806
14,JALISCO,1,TEQUILA,84,TALA,2195,331,397,0,728,328,389,0,717
14,JALISCO,1,TEQUILA,84,TALA,2196,1100,1181,0,2281,1088,1169,0,2257
14,JALISCO,1,TEQUILA,84,TALA,2197,597,646,0,1243,587,637,0,1224
14,JALISCO,1,TEQUILA,84,TALA,2198,1259,1344,0,2603,1247,1331,0,2578
14,JALISCO,1,TEQUILA,84,TALA,2199,675,679,0,1354,671,674,0,1345
14,JALISCO,1,TEQUILA,84,TALA,2200,660,631,0,1291,656,627,0,1283
14,JALISCO,1,TEQUILA,84,TALA,2201,512,549,0,1061,506,543,0,1049
14,JALISCO,1,TEQUILA,84,TALA,2202,507,470,0,977,506,469,0,975
14,JALISCO,1,TEQUILA,84,TALA,2204,693,713,0,1406,686,703,0,1389
14,JALISCO,1,TEQUILA,84,TALA,2205,888,956,0,1844,875,950,0,1825
14,JALISCO,1,TEQUILA,84,TALA,2206,868,967,0,1835,865,965,0,1830
14,JALISCO,1,TEQUILA,84,TALA,2207,918,910,0,1828,912,906,0,1818
14,JALISCO,1,TEQUILA,84,TALA,2208,884,924,0,1808,876,916,0,1792
14,JALISCO,1,TEQUILA,84,TALA,2209,580,593,0,1173,577,593,0,1170
14,JALISCO,1,TEQUILA,84,TALA,2210,2040,2154,0,4194,2014,2136,0,4150
14,JALISCO,1,TEQUILA,84,TALA,2211,286,298,0,584,285,297,0,582
14,JALISCO,1,TEQUILA,84,TALA,3665,329,377,0,706,326,374,0,700
14,JALISCO,1,TEQUILA,84,TALA,3666,158,146,0,304,154,145,0,299
14,JALISCO,1,TEQUILA,84,TALA,3746,1422,1483,0,2905,1408,1468,0,2876
14,JALISCO,1,TEQUILA,84,TALA,3747,1478,1484,0,2962,1459,1475,0,2934
14,JALISCO,1,TEQUILA,84,TALA,3748,380,369,0,749,375,366,0,741
14,JALISCO,1,TEQUILA,84,TALA,3749,1394,1475,0,2869,1371,1464,0,2835
14,JALISCO,1,TEQUILA,84,TALA,3750,275,295,0,570,274,293,0,567
14,JALISCO,1,TEQUILA,84,TALA,3751,326,362,0,688,322,360,0,682
14,JALISCO,1,TEQUILA,95,TEQUILA,2396,1523,1489,0,3012,1513,1478,0,2991
14,JALISCO,1,TEQUILA,95,TEQUILA,2397,324,373,0,697,319,370,0,689
14,JALISCO,1,TEQUILA,95,TEQUILA,2398,465,480,0,945,460,476,0,936
14,JALISCO,1,TEQUILA,95,TEQUILA,2399,625,649,0,1274,619,647,0,1266
14,JALISCO,1,TEQUILA,95,TEQUILA,2401,851,876,0,1727,845,864,0,1709
14,JALISCO,1,TEQUILA,95,TEQUILA,2402,458,483,0,941,454,481,0,935
14,JALISCO,1,TEQUILA,95,TEQUILA,2403,492,511,0,1003,491,506,0,997
14,JALISCO,1,TEQUILA,95,TEQUILA,2404,650,729,0,1379,645,722,0,1367
14,JALISCO,1,TEQUILA,95,TEQUILA,2405,657,666,0,1323,653,659,0,1312
14,JALISCO,1,TEQUILA,95,TEQUILA,2406,961,1092,0,2053,949,1080,0,2029
14,JALISCO,1,TEQUILA,95,TEQUILA,2407,2245,2249,0,4494,2224,2222,0,4446
14,JALISCO,1,TEQUILA,95,TEQUILA,2408,1304,1298,0,2602,1293,1290,0,2583
14,JALISCO,1,TEQUILA,95,TEQUILA,2409,116,99,0,215,114,98,0,212
14,JALISCO,1,TEQUILA,95,TEQUILA,2410,179,153,0,332,179,152,0,331
14,JALISCO,1,TEQUILA,95,TEQUILA,2411,107,104,0,211,107,103,0,210
14,JALISCO,1,TEQUILA,95,TEQUILA,2412,724,790,0,1514,720,784,0,1504
14,JALISCO,1,TEQUILA,95,TEQUILA,2413,879,919,0,1798,876,914,0,1790
14,JALISCO,1,TEQUILA,95,TEQUILA,2414,210,216,0,426,210,215,0,425
14,JALISCO,1,TEQUILA,95,TEQUILA,2415,459,449,0,908,458,447,0,905
14,JALISCO,1,TEQUILA,95,TEQUILA,2416,167,146,0,313,166,144,0,310
14,JALISCO,1,TEQUILA,95,TEQUILA,2417,585,614,0,1199,581,609,0,1190
14,JALISCO,1,TEQUILA,95,TEQUILA,3691,338,357,0,695,337,356,0,693
14,JALISCO,1,TEQUILA,95,TEQUILA,3692,695,745,0,1440,689,740,0,1429
14,JALISCO,1,TEQUILA,95,TEQUILA,3693,57,51,0,108,57,51,0,108
14,JALISCO,1,TEQUILA,95,TEQUILA,3752,952,1036,0,1988,942,1028,0,1970
14,JALISCO,1,TEQUILA,95,TEQUILA,3753,950,998,0,1948,945,994,0,1939
14,JALISCO,1,TEQUILA,96,TEUCHITLAN,2418,996,1105,0,2101,977,1085,0,2062
14,JALISCO,1,TEQUILA,96,TEUCHITLAN,2419,727,756,0,1483,716,742,0,1458
14,JALISCO,1,TEQUILA,96,TEUCHITLAN,2420,329,353,0,682,324,352,0,676
14,JALISCO,1,TEQUILA,96,TEUCHITLAN,2421,273,279,0,552,267,276,0,543
14,JALISCO,1,TEQUILA,96,TEUCHITLAN,2422,824,840,0,1664,816,831,0,1647
14,JALISCO,1,TEQUILA,96,TEUCHITLAN,2423,977,1013,0,1990,959,997,0,1956
14,JALISCO,1,TEQUILA,105,TOTATICHE,2742,499,521,0,1020,486,499,0,985
14,JALISCO,1,TEQUILA,105,TOTATICHE,2743,433,429,0,862,415,416,0,831
14,JALISCO,1,TEQUILA,105,TOTATICHE,2744,149,119,0,268,148,117,0,265
14,JALISCO,1,TEQUILA,105,TOTATICHE,2745,116,108,0,224,109,104,0,213
14,JALISCO,1,TEQUILA,105,TOTATICHE,2746,195,198,0,393,189,195,0,384
14,JALISCO,1,TEQUILA,105,TOTATICHE,2747,828,802,0,1630,811,783,0,1594
14,JALISCO,1,TEQUILA,115,VILLA GUERRERO,2839,451,469,0,920,439,461,0,900
14,JALISCO,1,TEQUILA,115,VILLA GUERRERO,2840,349,357,0,706,348,353,0,701
14,JALISCO,1,TEQUILA,115,VILLA GUERRERO,2841,619,672,0,1291,605,660,0,1265
14,JALISCO,1,TEQUILA,115,VILLA GUERRERO,2842,562,580,0,1142,553,570,0,1123
14,JALISCO,1,TEQUILA,115,VILLA GUERRERO,2844,185,184,0,369,183,184,0,367
14,JALISCO,1,TEQUILA,115,VILLA GUERRERO,2845,137,141,0,278,137,140,0,277
14,JALISCO,1,TEQUILA,115,VILLA GUERRERO,2846,50,38,0,88,49,38,0,87
14,JALISCO,2,LAGOS DE MORENO,36,ENCARNACION DE DIAZ,501,1885,2136,0,4021,1861,2106,0,3967
14,JALISCO,2,LAGOS DE MORENO,36,ENCARNACION DE DIAZ,502,453,526,0,979,446,521,0,967
14,JALISCO,2,LAGOS DE MORENO,36,ENCARNACION DE DIAZ,503,510,561,0,1071,507,556,0,1063
14,JALISCO,2,LAGOS DE MORENO,36,ENCARNACION DE DIAZ,504,1372,1560,0,2932,1352,1538,0,2890
14,JALISCO,2,LAGOS DE MORENO,36,ENCARNACION DE DIAZ,505,1835,2011,0,3846,1807,1995,0,3802
14,JALISCO,2,LAGOS DE MORENO,36,ENCARNACION DE DIAZ,506,715,863,0,1578,707,846,0,1553
14,JALISCO,2,LAGOS DE MORENO,36,ENCARNACION DE DIAZ,507,338,415,0,753,328,410,0,738
14,JALISCO,2,LAGOS DE MORENO,36,ENCARNACION DE DIAZ,508,610,670,0,1280,604,658,0,1262
14,JALISCO,2,LAGOS DE MORENO,36,ENCARNACION DE DIAZ,509,1356,1497,0,2853,1341,1486,0,2827
14,JALISCO,2,LAGOS DE MORENO,36,ENCARNACION DE DIAZ,510,676,757,0,1433,668,749,0,1417
14,JALISCO,2,LAGOS DE MORENO,36,ENCARNACION DE DIAZ,511,274,275,0,549,272,275,0,547
14,JALISCO,2,LAGOS DE MORENO,36,ENCARNACION DE DIAZ,512,887,962,0,1849,884,958,0,1842
14,JALISCO,2,LAGOS DE MORENO,36,ENCARNACION DE DIAZ,513,235,254,0,489,233,252,0,485
14,JALISCO,2,LAGOS DE MORENO,36,ENCARNACION DE DIAZ,514,112,113,0,225,111,113,0,224
14,JALISCO,2,LAGOS DE MORENO,36,ENCARNACION DE DIAZ,518,218,234,0,452,218,234,0,452
14,JALISCO,2,LAGOS DE MORENO,36,ENCARNACION DE DIAZ,519,171,181,0,352,170,179,0,349
14,JALISCO,2,LAGOS DE MORENO,36,ENCARNACION DE DIAZ,520,1080,1196,0,2276,1052,1166,0,2218
14,JALISCO,2,LAGOS DE MORENO,36,ENCARNACION DE DIAZ,521,653,681,0,1334,649,674,0,1323
14,JALISCO,2,LAGOS DE MORENO,36,ENCARNACION DE DIAZ,522,192,205,0,397,192,205,0,397
14,JALISCO,2,LAGOS DE MORENO,36,ENCARNACION DE DIAZ,523,71,82,0,153,70,81,0,151
14,JALISCO,2,LAGOS DE MORENO,36,ENCARNACION DE DIAZ,524,86,92,0,178,86,92,0,178
14,JALISCO,2,LAGOS DE MORENO,36,ENCARNACION DE DIAZ,525,980,1022,0,2002,971,1011,0,1982
14,JALISCO,2,LAGOS DE MORENO,36,ENCARNACION DE DIAZ,526,771,874,0,1645,761,865,0,1626
14,JALISCO,2,LAGOS DE MORENO,36,ENCARNACION DE DIAZ,527,1083,1154,0,2237,1072,1143,0,2215
14,JALISCO,2,LAGOS DE MORENO,36,ENCARNACION DE DIAZ,528,155,167,0,322,155,165,0,320
14,JALISCO,2,LAGOS DE MORENO,36,ENCARNACION DE DIAZ,529,128,141,0,269,126,139,0,265
14,JALISCO,2,LAGOS DE MORENO,36,ENCARNACION DE DIAZ,3358,295,342,0,637,294,342,0,636
14,JALISCO,2,LAGOS DE MORENO,36,ENCARNACION DE DIAZ,3359,352,428,0,780,349,426,0,775
14,JALISCO,2,LAGOS DE MORENO,36,ENCARNACION DE DIAZ,3360,323,413,0,736,319,411,0,730
14,JALISCO,2,LAGOS DE MORENO,36,ENCARNACION DE DIAZ,3361,175,166,0,341,174,164,0,338
14,JALISCO,2,LAGOS DE MORENO,36,ENCARNACION DE DIAZ,3362,280,265,0,545,277,262,0,539
14,JALISCO,2,LAGOS DE MORENO,55,LAGOS DE MORENO,1702,2238,2445,0,4683,2214,2423,0,4637
14,JALISCO,2,LAGOS DE MORENO,55,LAGOS DE MORENO,1703,1363,1443,0,2806,1352,1435,0,2787
14,JALISCO,2,LAGOS DE MORENO,55,LAGOS DE MORENO,1704,779,895,0,1674,773,886,0,1659
14,JALISCO,2,LAGOS DE MORENO,55,LAGOS DE MORENO,1705,338,386,0,724,336,385,0,721
14,JALISCO,2,LAGOS DE MORENO,55,LAGOS DE MORENO,1706,1450,1557,0,3007,1435,1545,0,2980
14,JALISCO,2,LAGOS DE MORENO,55,LAGOS DE MORENO,1707,1553,1859,0,3412,1540,1847,0,3387
14,JALISCO,2,LAGOS DE MORENO,55,LAGOS DE MORENO,1708,729,766,0,1495,723,758,0,1481
14,JALISCO,2,LAGOS DE MORENO,55,LAGOS DE MORENO,1709,677,805,0,1482,669,799,0,1468
14,JALISCO,2,LAGOS DE MORENO,55,LAGOS DE MORENO,1710,482,554,0,1036,482,552,0,1034
14,JALISCO,2,LAGOS DE MORENO,55,LAGOS DE MORENO,1711,2198,2432,0,4630,2183,2410,0,4593
14,JALISCO,2,LAGOS DE MORENO,55,LAGOS DE MORENO,1712,393,465,0,858,392,464,0,856
14,JALISCO,2,LAGOS DE MORENO,55,LAGOS DE MORENO,1713,4198,4428,0,8626,4170,4397,0,8567
14,JALISCO,2,LAGOS DE MORENO,55,LAGOS DE MORENO,1714,845,947,0,1792,841,943,0,1784
14,JALISCO,2,LAGOS DE MORENO,55,LAGOS DE MORENO,1716,138,168,0,306,138,167,0,305
14,JALISCO,2,LAGOS DE MORENO,55,LAGOS DE MORENO,1717,280,355,0,635,278,352,0,630
14,JALISCO,2,LAGOS DE MORENO,55,LAGOS DE MORENO,1718,152,186,0,338,149,184,0,333
14,JALISCO,2,LAGOS DE MORENO,55,LAGOS DE MORENO,1719,608,727,0,1335,601,724,0,1325
14,JALISCO,2,LAGOS DE MORENO,55,LAGOS DE MORENO,1720,395,408,0,803,394,403,0,797
14,JALISCO,2,LAGOS DE MORENO,55,LAGOS DE MORENO,1721,498,540,0,1038,490,536,0,1026
14,JALISCO,2,LAGOS DE MORENO,55,LAGOS DE MORENO,1722,411,438,0,849,409,432,0,841
14,JALISCO,2,LAGOS DE MORENO,55,LAGOS DE MORENO,1723,413,467,1,881,410,464,1,875
14,JALISCO,2,LAGOS DE MORENO,55,LAGOS DE MORENO,1724,236,295,0,531,236,292,0,528
14,JALISCO,2,LAGOS DE MORENO,55,LAGOS DE MORENO,1725,81,89,0,170,81,89,0,170
14,JALISCO,2,LAGOS DE MORENO,55,LAGOS DE MORENO,1726,256,309,0,565,256,309,0,565
14,JALISCO,2,LAGOS DE MORENO,55,LAGOS DE MORENO,1728,193,251,0,444,191,251,0,442
14,JALISCO,2,LAGOS DE MORENO,55,LAGOS DE MORENO,1729,740,824,0,1564,733,815,0,1548
14,JALISCO,2,LAGOS DE MORENO,55,LAGOS DE MORENO,1730,569,643,0,1212,566,638,0,1204
14,JALISCO,2,LAGOS DE MORENO,55,LAGOS DE MORENO,1731,2225,2407,0,4632,2214,2393,0,4607
14,JALISCO,2,LAGOS DE MORENO,55,LAGOS DE MORENO,1732,1397,1540,0,2937,1383,1521,0,2904
14,JALISCO,2,LAGOS DE MORENO,55,LAGOS DE MORENO,1733,469,555,0,1024,464,554,0,1018
14,JALISCO,2,LAGOS DE MORENO,55,LAGOS DE MORENO,1735,1872,2073,0,3945,1853,2062,0,3915
14,JALISCO,2,LAGOS DE MORENO,55,LAGOS DE MORENO,1736,760,800,0,1560,757,796,0,1553
14,JALISCO,2,LAGOS DE MORENO,55,LAGOS DE MORENO,1737,2546,2589,0,5135,2519,2556,0,5075
14,JALISCO,2,LAGOS DE MORENO,55,LAGOS DE MORENO,1738,386,422,0,808,382,421,0,803
14,JALISCO,2,LAGOS DE MORENO,55,LAGOS DE MORENO,1739,522,535,0,1057,520,534,0,1054
14,JALISCO,2,LAGOS DE MORENO,55,LAGOS DE MORENO,1740,394,429,0,823,392,426,0,818
14,JALISCO,2,LAGOS DE MORENO,55,LAGOS DE MORENO,1741,382,409,0,791,382,406,0,788
14,JALISCO,2,LAGOS DE MORENO,55,LAGOS DE MORENO,1742,219,229,0,448,219,229,0,448
14,JALISCO,2,LAGOS DE MORENO,55,LAGOS DE MORENO,1743,334,363,0,697,333,362,0,695
14,JALISCO,2,LAGOS DE MORENO,55,LAGOS DE MORENO,1744,56,59,0,115,56,59,0,115
14,JALISCO,2,LAGOS DE MORENO,55,LAGOS DE MORENO,1745,224,265,0,489,223,263,0,486
14,JALISCO,2,LAGOS DE MORENO,55,LAGOS DE MORENO,1746,199,239,0,438,196,238,0,434
14,JALISCO,2,LAGOS DE MORENO,55,LAGOS DE MORENO,1747,408,478,0,886,407,473,0,880
14,JALISCO,2,LAGOS DE MORENO,55,LAGOS DE MORENO,1749,1393,1582,0,2975,1382,1577,0,2959
14,JALISCO,2,LAGOS DE MORENO,55,LAGOS DE MORENO,1751,95,126,0,221,95,126,0,221
14,JALISCO,2,LAGOS DE MORENO,55,LAGOS DE MORENO,1752,182,156,0,338,182,156,0,338
14,JALISCO,2,LAGOS DE MORENO,55,LAGOS DE MORENO,1753,114,126,0,240,114,126,0,240
14,JALISCO,2,LAGOS DE MORENO,55,LAGOS DE MORENO,1754,1111,1264,0,2375,1106,1252,0,2358
14,JALISCO,2,LAGOS DE MORENO,55,LAGOS DE MORENO,1755,520,554,0,1074,516,553,0,1069
14,JALISCO,2,LAGOS DE MORENO,55,LAGOS DE MORENO,1756,119,118,0,237,119,118,0,237
14,JALISCO,2,LAGOS DE MORENO,55,LAGOS DE MORENO,1757,484,518,0,1002,483,514,0,997
14,JALISCO,2,LAGOS DE MORENO,55,LAGOS DE MORENO,1758,95,105,0,200,95,105,0,200
14,JALISCO,2,LAGOS DE MORENO,55,LAGOS DE MORENO,1759,463,491,0,954,460,488,0,948
14,JALISCO,2,LAGOS DE MORENO,55,LAGOS DE MORENO,1760,900,1040,0,1940,897,1035,0,1932
14,JALISCO,2,LAGOS DE MORENO,55,LAGOS DE MORENO,1761,631,729,0,1360,626,721,0,1347
14,JALISCO,2,LAGOS DE MORENO,55,LAGOS DE MORENO,1762,545,560,0,1105,535,557,0,1092
14,JALISCO,2,LAGOS DE MORENO,55,LAGOS DE MORENO,1764,206,215,0,421,202,213,0,415
14,JALISCO,2,LAGOS DE MORENO,55,LAGOS DE MORENO,1765,284,271,0,555,280,271,0,551
14,JALISCO,2,LAGOS DE MORENO,55,LAGOS DE MORENO,1766,144,166,0,310,141,164,0,305
14,JALISCO,2,LAGOS DE MORENO,55,LAGOS DE MORENO,1767,764,766,0,1530,760,760,0,1520
14,JALISCO,2,LAGOS DE MORENO,55,LAGOS DE MORENO,1768,556,567,0,1123,555,564,0,1119
14,JALISCO,2,LAGOS DE MORENO,55,LAGOS DE MORENO,1769,2264,2436,0,4700,2245,2413,0,4658
14,JALISCO,2,LAGOS DE MORENO,55,LAGOS DE MORENO,1770,116,124,0,240,116,124,0,240
14,JALISCO,2,LAGOS DE MORENO,55,LAGOS DE MORENO,1772,1224,1250,0,2474,1212,1240,0,2452
14,JALISCO,2,LAGOS DE MORENO,55,LAGOS DE MORENO,1773,483,478,0,961,478,477,0,955
14,JALISCO,2,LAGOS DE MORENO,55,LAGOS DE MORENO,1774,181,197,1,379,179,194,1,374
14,JALISCO,2,LAGOS DE MORENO,55,LAGOS DE MORENO,1775,161,142,0,303,159,141,0,300
14,JALISCO,2,LAGOS DE MORENO,55,LAGOS DE MORENO,3645,839,907,0,1746,835,898,0,1733
14,JALISCO,2,LAGOS DE MORENO,55,LAGOS DE MORENO,3646,615,661,0,1276,609,659,0,1268
14,JALISCO,2,LAGOS DE MORENO,55,LAGOS DE MORENO,3647,1121,1180,0,2301,1114,1173,0,2287
14,JALISCO,2,LAGOS DE MORENO,55,LAGOS DE MORENO,3648,972,1034,0,2006,962,1027,0,1989
14,JALISCO,2,LAGOS DE MORENO,55,LAGOS DE MORENO,3649,900,932,0,1832,891,921,0,1812
14,JALISCO,2,LAGOS DE MORENO,55,LAGOS DE MORENO,3695,937,1006,0,1943,929,996,0,1925
14,JALISCO,2,LAGOS DE MORENO,55,LAGOS DE MORENO,3696,1425,1575,0,3000,1412,1555,0,2967
14,JALISCO,2,LAGOS DE MORENO,55,LAGOS DE MORENO,3754,445,478,0,923,442,474,0,916
14,JALISCO,2,LAGOS DE MORENO,55,LAGOS DE MORENO,3755,654,695,0,1349,646,688,0,1334
14,JALISCO,2,LAGOS DE MORENO,55,LAGOS DE MORENO,3756,1319,1427,0,2746,1310,1419,0,2729
14,JALISCO,2,LAGOS DE MORENO,55,LAGOS DE MORENO,3757,520,562,0,1082,518,558,0,1076
14,JALISCO,2,LAGOS DE MORENO,55,LAGOS DE MORENO,3758,957,1073,1,2031,949,1071,1,2021
14,JALISCO,2,LAGOS DE MORENO,55,LAGOS DE MORENO,3759,1458,1654,0,3112,1448,1644,0,3092
14,JALISCO,2,LAGOS DE MORENO,55,LAGOS DE MORENO,3880,554,670,0,1224,544,667,0,1211
14,JALISCO,2,LAGOS DE MORENO,55,LAGOS DE MORENO,3881,967,1010,0,1977,956,1002,0,1958
14,JALISCO,2,LAGOS DE MORENO,66,OJUELOS DE JALISCO,1886,1045,1223,0,2268,1034,1204,0,2238
14,JALISCO,2,LAGOS DE MORENO,66,OJUELOS DE JALISCO,1887,1113,1275,0,2388,1097,1257,0,2354
14,JALISCO,2,LAGOS DE MORENO,66,OJUELOS DE JALISCO,1888,783,828,0,1611,776,816,0,1592
14,JALISCO,2,LAGOS DE MORENO,66,OJUELOS DE JALISCO,1889,1651,1818,0,3469,1630,1794,0,3424
14,JALISCO,2,LAGOS DE MORENO,66,OJUELOS DE JALISCO,1890,380,414,0,794,377,411,0,788
14,JALISCO,2,LAGOS DE MORENO,66,OJUELOS DE JALISCO,1891,216,254,0,470,214,251,0,465
14,JALISCO,2,LAGOS DE MORENO,66,OJUELOS DE JALISCO,1892,1354,1570,0,2924,1345,1558,0,2903
14,JALISCO,2,LAGOS DE MORENO,66,OJUELOS DE JALISCO,1893,671,724,0,1395,664,718,0,1382
14,JALISCO,2,LAGOS DE MORENO,66,OJUELOS DE JALISCO,1894,193,254,0,447,191,253,0,444
14,JALISCO,2,LAGOS DE MORENO,66,OJUELOS DE JALISCO,1895,584,662,0,1246,579,658,0,1237
14,JALISCO,2,LAGOS DE MORENO,66,OJUELOS DE JALISCO,1896,811,885,0,1696,803,880,0,1683
14,JALISCO,2,LAGOS DE MORENO,66,OJUELOS DE JALISCO,1897,549,560,0,1109,546,559,0,1105
14,JALISCO,2,LAGOS DE MORENO,66,OJUELOS DE JALISCO,1898,207,225,0,432,206,223,0,429
14,JALISCO,2,LAGOS DE MORENO,66,OJUELOS DE JALISCO,1899,449,480,0,929,444,475,0,919
14,JALISCO,2,LAGOS DE MORENO,66,OJUELOS DE JALISCO,1900,574,653,0,1227,570,650,0,1220
14,JALISCO,2,LAGOS DE MORENO,75,SAN JUAN DE LOS LAGOS,2064,731,838,0,1569,724,826,0,1550
14,JALISCO,2,LAGOS DE MORENO,75,SAN JUAN DE LOS LAGOS,2065,503,497,0,1000,497,491,0,988
14,JALISCO,2,LAGOS DE MORENO,75,SAN JUAN DE LOS LAGOS,2066,2254,2328,0,4582,2230,2313,0,4543
14,JALISCO,2,LAGOS DE MORENO,75,SAN JUAN DE LOS LAGOS,2068,1834,1946,0,3780,1816,1925,0,3741
14,JALISCO,2,LAGOS DE MORENO,75,SAN JUAN DE LOS LAGOS,2069,585,648,0,1233,580,641,0,1221
14,JALISCO,2,LAGOS DE MORENO,75,SAN JUAN DE LOS LAGOS,2070,202,225,0,427,201,223,0,424
14,JALISCO,2,LAGOS DE MORENO,75,SAN JUAN DE LOS LAGOS,2071,632,642,0,1274,619,637,0,1256
14,JALISCO,2,LAGOS DE MORENO,75,SAN JUAN DE LOS LAGOS,2072,170,216,0,386,169,215,0,384
14,JALISCO,2,LAGOS DE MORENO,75,SAN JUAN DE LOS LAGOS,2073,298,278,0,576,295,276,0,571
14,JALISCO,2,LAGOS DE MORENO,75,SAN JUAN DE LOS LAGOS,2074,1072,1184,0,2256,1052,1178,0,2230
14,JALISCO,2,LAGOS DE MORENO,75,SAN JUAN DE LOS LAGOS,2075,1125,1181,0,2306,1113,1175,0,2288
14,JALISCO,2,LAGOS DE MORENO,75,SAN JUAN DE LOS LAGOS,2076,1733,1819,0,3552,1716,1806,0,3522
14,JALISCO,2,LAGOS DE MORENO,75,SAN JUAN DE LOS LAGOS,2077,480,562,0,1042,473,547,0,1020
14,JALISCO,2,LAGOS DE MORENO,75,SAN JUAN DE LOS LAGOS,2078,741,772,0,1513,732,762,0,1494
14,JALISCO,2,LAGOS DE MORENO,75,SAN JUAN DE LOS LAGOS,2079,1935,2106,0,4041,1912,2087,0,3999
14,JALISCO,2,LAGOS DE MORENO,75,SAN JUAN DE LOS LAGOS,2080,170,181,0,351,168,181,0,349
14,JALISCO,2,LAGOS DE MORENO,75,SAN JUAN DE LOS LAGOS,2081,517,601,0,1118,514,596,0,1110
14,JALISCO,2,LAGOS DE MORENO,75,SAN JUAN DE LOS LAGOS,2082,271,276,0,547,266,272,0,538
14,JALISCO,2,LAGOS DE MORENO,75,SAN JUAN DE LOS LAGOS,2083,554,486,0,1040,548,483,0,1031
14,JALISCO,2,LAGOS DE MORENO,75,SAN JUAN DE LOS LAGOS,2084,531,593,0,1124,527,590,0,1117
14,JALISCO,2,LAGOS DE MORENO,75,SAN JUAN DE LOS LAGOS,2085,233,232,0,465,233,231,0,464
14,JALISCO,2,LAGOS DE MORENO,75,SAN JUAN DE LOS LAGOS,2086,355,333,0,688,354,331,0,685
14,JALISCO,2,LAGOS DE MORENO,75,SAN JUAN DE LOS LAGOS,2087,419,395,0,814,416,391,0,807
14,JALISCO,2,LAGOS DE MORENO,75,SAN JUAN DE LOS LAGOS,2088,368,359,0,727,362,356,0,718
14,JALISCO,2,LAGOS DE MORENO,75,SAN JUAN DE LOS LAGOS,2089,217,234,0,451,214,233,0,447
14,JALISCO,2,LAGOS DE MORENO,75,SAN JUAN DE LOS LAGOS,2090,170,183,0,353,169,180,0,349
14,JALISCO,2,LAGOS DE MORENO,75,SAN JUAN DE LOS LAGOS,2091,182,158,0,340,180,157,0,337
14,JALISCO,2,LAGOS DE MORENO,75,SAN JUAN DE LOS LAGOS,2092,324,345,0,669,322,342,0,664
14,JALISCO,2,LAGOS DE MORENO,75,SAN JUAN DE LOS LAGOS,2093,1719,1783,0,3502,1703,1768,0,3471
14,JALISCO,2,LAGOS DE MORENO,75,SAN JUAN DE LOS LAGOS,2094,1181,1190,0,2371,1172,1186,0,2358
14,JALISCO,2,LAGOS DE MORENO,75,SAN JUAN DE LOS LAGOS,2095,114,119,0,233,111,118,0,229
14,JALISCO,2,LAGOS DE MORENO,75,SAN JUAN DE LOS LAGOS,2096,93,86,0,179,92,85,0,177
14,JALISCO,2,LAGOS DE MORENO,75,SAN JUAN DE LOS LAGOS,3650,1575,1647,0,3222,1567,1637,0,3204
14,JALISCO,2,LAGOS DE MORENO,75,SAN JUAN DE LOS LAGOS,3651,1124,1203,0,2327,1112,1193,0,2305
14,JALISCO,2,LAGOS DE MORENO,75,SAN JUAN DE LOS LAGOS,3667,136,156,0,292,136,155,0,291
14,JALISCO,2,LAGOS DE MORENO,75,SAN JUAN DE LOS LAGOS,3668,80,74,0,154,78,74,0,152
14,JALISCO,2,LAGOS DE MORENO,75,SAN JUAN DE LOS LAGOS,3669,158,165,0,323,157,165,0,322
14,JALISCO,2,LAGOS DE MORENO,75,SAN JUAN DE LOS LAGOS,3670,131,126,0,257,131,124,0,255
14,JALISCO,2,LAGOS DE MORENO,75,SAN JUAN DE LOS LAGOS,3760,625,616,0,1241,619,614,0,1233
14,JALISCO,2,LAGOS DE MORENO,75,SAN JUAN DE LOS LAGOS,3761,1117,1095,0,2212,1104,1083,0,2187
14,JALISCO,2,LAGOS DE MORENO,75,SAN JUAN DE LOS LAGOS,3762,978,1070,0,2048,968,1062,0,2030
14,JALISCO,2,LAGOS DE MORENO,75,SAN JUAN DE LOS LAGOS,3763,921,1053,0,1974,909,1042,0,1951
14,JALISCO,2,LAGOS DE MORENO,92,TEOCALTICHE,2307,1092,1292,0,2384,1083,1280,0,2363
14,JALISCO,2,LAGOS DE MORENO,92,TEOCALTICHE,2308,1438,1565,0,3003,1427,1557,0,2984
14,JALISCO,2,LAGOS DE MORENO,92,TEOCALTICHE,2309,459,530,0,989,457,526,0,983
14,JALISCO,2,LAGOS DE MORENO,92,TEOCALTICHE,2310,276,327,0,603,274,322,0,596
14,JALISCO,2,LAGOS DE MORENO,92,TEOCALTICHE,2311,484,554,0,1038,480,550,0,1030
14,JALISCO,2,LAGOS DE MORENO,92,TEOCALTICHE,2312,193,237,0,430,190,236,0,426
14,JALISCO,2,LAGOS DE MORENO,92,TEOCALTICHE,2313,630,687,0,1317,625,685,0,1310
14,JALISCO,2,LAGOS DE MORENO,92,TEOCALTICHE,2314,152,196,0,348,151,194,0,345
14,JALISCO,2,LAGOS DE MORENO,92,TEOCALTICHE,2315,612,761,0,1373,606,754,0,1360
14,JALISCO,2,LAGOS DE MORENO,92,TEOCALTICHE,2316,1385,1590,0,2975,1380,1585,0,2965
14,JALISCO,2,LAGOS DE MORENO,92,TEOCALTICHE,2317,324,401,0,725,320,400,0,720
14,JALISCO,2,LAGOS DE MORENO,92,TEOCALTICHE,2318,2524,2790,0,5314,2502,2772,0,5274
14,JALISCO,2,LAGOS DE MORENO,92,TEOCALTICHE,2319,939,1020,0,1959,923,1001,0,1924
14,JALISCO,2,LAGOS DE MORENO,92,TEOCALTICHE,2320,975,1099,0,2074,956,1085,0,2041
14,JALISCO,2,LAGOS DE MORENO,92,TEOCALTICHE,2321,280,292,0,572,275,291,0,566
14,JALISCO,2,LAGOS DE MORENO,92,TEOCALTICHE,2322,498,498,0,996,486,485,0,971
14,JALISCO,2,LAGOS DE MORENO,92,TEOCALTICHE,2323,743,754,0,1497,733,734,0,1467
14,JALISCO,2,LAGOS DE MORENO,92,TEOCALTICHE,2324,646,699,0,1345,627,675,0,1302
14,JALISCO,2,LAGOS DE MORENO,92,TEOCALTICHE,2325,437,470,0,907,429,458,0,887
14,JALISCO,2,LAGOS DE MORENO,92,TEOCALTICHE,2326,420,445,0,865,415,440,0,855
14,JALISCO,2,LAGOS DE MORENO,92,TEOCALTICHE,2327,180,171,0,351,180,169,0,349
14,JALISCO,2,LAGOS DE MORENO,92,TEOCALTICHE,2328,498,559,0,1057,496,558,0,1054
14,JALISCO,2,LAGOS DE MORENO,92,TEOCALTICHE,2329,83,72,0,155,82,70,0,152
14,JALISCO,2,LAGOS DE MORENO,110,UNION DE SAN ANTONIO,2794,1839,1994,0,3833,1826,1983,0,3809
14,JALISCO,2,LAGOS DE MORENO,110,UNION DE SAN ANTONIO,2795,328,366,0,694,323,364,0,687
14,JALISCO,2,LAGOS DE MORENO,110,UNION DE SAN ANTONIO,2796,1161,1295,0,2456,1155,1290,0,2445
14,JALISCO,2,LAGOS DE MORENO,110,UNION DE SAN ANTONIO,2797,749,782,0,1531,734,768,0,1502
14,JALISCO,2,LAGOS DE MORENO,110,UNION DE SAN ANTONIO,2798,289,329,0,618,286,329,0,615
14,JALISCO,2,LAGOS DE MORENO,110,UNION DE SAN ANTONIO,2799,344,356,0,700,341,355,0,696
14,JALISCO,2,LAGOS DE MORENO,110,UNION DE SAN ANTONIO,2800,1035,1138,0,2173,1026,1128,0,2154
14,JALISCO,2,LAGOS DE MORENO,110,UNION DE SAN ANTONIO,2801,363,397,0,760,360,395,0,755
14,JALISCO,2,LAGOS DE MORENO,110,UNION DE SAN ANTONIO,2802,81,84,0,165,80,84,0,164
14,JALISCO,2,LAGOS DE MORENO,110,UNION DE SAN ANTONIO,2803,946,1086,0,2032,937,1078,0,2015
14,JALISCO,2,LAGOS DE MORENO,116,VILLA HIDALGO,2847,1968,2206,0,4174,1912,2163,0,4075
14,JALISCO,2,LAGOS DE MORENO,116,VILLA HIDALGO,2848,990,1117,0,2107,970,1090,0,2060
14,JALISCO,2,LAGOS DE MORENO,116,VILLA HIDALGO,2849,1175,1277,0,2452,1156,1260,0,2416
14,JALISCO,2,LAGOS DE MORENO,116,VILLA HIDALGO,2850,1518,1650,0,3168,1481,1618,0,3099
14,JALISCO,2,LAGOS DE MORENO,116,VILLA HIDALGO,2851,408,477,0,885,404,472,0,876
14,JALISCO,2,LAGOS DE MORENO,116,VILLA HIDALGO,2852,334,370,0,704,328,360,0,688
14,JALISCO,2,LAGOS DE MORENO,116,VILLA HIDALGO,2853,243,242,0,485,239,240,0,479
14,JALISCO,2,LAGOS DE MORENO,116,VILLA HIDALGO,2854,1074,1153,0,2227,1038,1121,0,2159
14,JALISCO,3,TEPATITLAN DE MORELOS,1,ACATIC,1,853,936,0,1789,836,931,0,1767
14,JALISCO,3,TEPATITLAN DE MORELOS,1,ACATIC,2,632,688,0,1320,625,679,0,1304
14,JALISCO,3,TEPATITLAN DE MORELOS,1,ACATIC,3,1203,1316,0,2519,1179,1291,0,2470
14,JALISCO,3,TEPATITLAN DE MORELOS,1,ACATIC,4,1279,1282,0,2561,1269,1269,0,2538
14,JALISCO,3,TEPATITLAN DE MORELOS,1,ACATIC,5,1332,1448,0,2780,1318,1431,0,2749
14,JALISCO,3,TEPATITLAN DE MORELOS,1,ACATIC,6,738,811,0,1549,733,807,0,1540
14,JALISCO,3,TEPATITLAN DE MORELOS,1,ACATIC,7,413,435,0,848,410,432,0,842
14,JALISCO,3,TEPATITLAN DE MORELOS,1,ACATIC,8,86,67,0,153,86,67,0,153
14,JALISCO,3,TEPATITLAN DE MORELOS,1,ACATIC,10,1242,1342,0,2584,1225,1327,0,2552
14,JALISCO,3,TEPATITLAN DE MORELOS,1,ACATIC,11,727,758,0,1485,713,749,0,1462
14,JALISCO,3,TEPATITLAN DE MORELOS,1,ACATIC,12,447,426,0,873,444,423,0,867
14,JALISCO,3,TEPATITLAN DE MORELOS,30,CUQUIO,445,1101,1189,0,2290,1090,1176,0,2266
14,JALISCO,3,TEPATITLAN DE MORELOS,30,CUQUIO,446,1253,1319,0,2572,1229,1297,0,2526
14,JALISCO,3,TEPATITLAN DE MORELOS,30,CUQUIO,447,497,594,0,1091,494,590,0,1084
14,JALISCO,3,TEPATITLAN DE MORELOS,30,CUQUIO,448,627,701,0,1328,623,697,0,1320
14,JALISCO,3,TEPATITLAN DE MORELOS,30,CUQUIO,449,428,443,0,871,418,439,0,857
14,JALISCO,3,TEPATITLAN DE MORELOS,30,CUQUIO,450,629,720,0,1349,623,715,0,1338
14,JALISCO,3,TEPATITLAN DE MORELOS,30,CUQUIO,451,455,414,0,869,447,408,0,855
14,JALISCO,3,TEPATITLAN DE MORELOS,30,CUQUIO,452,321,312,0,633,321,309,0,630
14,JALISCO,3,TEPATITLAN DE MORELOS,30,CUQUIO,453,579,642,0,1221,577,638,0,1215
14,JALISCO,3,TEPATITLAN DE MORELOS,30,CUQUIO,454,486,525,0,1011,484,520,0,1004
14,JALISCO,3,TEPATITLAN DE MORELOS,30,CUQUIO,455,498,552,0,1050,496,547,0,1043
14,JALISCO,3,TEPATITLAN DE MORELOS,30,CUQUIO,456,413,446,0,859,410,442,0,852
14,JALISCO,3,TEPATITLAN DE MORELOS,47,IXTLAHUACAN DEL RIO,1602,1053,1135,0,2188,1035,1116,0,2151
14,JALISCO,3,TEPATITLAN DE MORELOS,47,IXTLAHUACAN DEL RIO,1603,705,785,0,1490,702,781,0,1483
14,JALISCO,3,TEPATITLAN DE MORELOS,47,IXTLAHUACAN DEL RIO,1604,1139,1292,0,2431,1127,1276,0,2403
14,JALISCO,3,TEPATITLAN DE MORELOS,47,IXTLAHUACAN DEL RIO,1605,617,656,0,1273,614,652,0,1266
14,JALISCO,3,TEPATITLAN DE MORELOS,47,IXTLAHUACAN DEL RIO,1606,403,436,0,839,394,430,0,824
14,JALISCO,3,TEPATITLAN DE MORELOS,47,IXTLAHUACAN DEL RIO,1607,669,717,0,1386,657,705,0,1362
14,JALISCO,3,TEPATITLAN DE MORELOS,47,IXTLAHUACAN DEL RIO,1608,659,657,0,1316,651,649,0,1300
14,JALISCO,3,TEPATITLAN DE MORELOS,47,IXTLAHUACAN DEL RIO,1609,1039,1157,0,2196,1026,1149,0,2175
14,JALISCO,3,TEPATITLAN DE MORELOS,47,IXTLAHUACAN DEL RIO,1610,604,603,0,1207,594,593,0,1187
14,JALISCO,3,TEPATITLAN DE MORELOS,47,IXTLAHUACAN DEL RIO,1611,415,442,0,857,413,439,0,852
14,JALISCO,3,TEPATITLAN DE MORELOS,47,IXTLAHUACAN DEL RIO,1612,433,463,0,896,427,456,0,883
14,JALISCO,3,TEPATITLAN DE MORELOS,47,IXTLAHUACAN DEL RIO,3662,409,427,0,836,403,422,0,825
14,JALISCO,3,TEPATITLAN DE MORELOS,53,JUANACATLAN,1689,724,734,0,1458,715,726,0,1441
14,JALISCO,3,TEPATITLAN DE MORELOS,53,JUANACATLAN,1690,798,799,0,1597,789,790,0,1579
14,JALISCO,3,TEPATITLAN DE MORELOS,53,JUANACATLAN,1691,1045,1108,0,2153,1038,1099,0,2137
14,JALISCO,3,TEPATITLAN DE MORELOS,53,JUANACATLAN,1692,1332,1321,0,2653,1315,1311,0,2626
14,JALISCO,3,TEPATITLAN DE MORELOS,53,JUANACATLAN,1693,398,389,0,787,397,386,0,783
14,JALISCO,3,TEPATITLAN DE MORELOS,53,JUANACATLAN,1694,4297,4662,0,8959,4243,4620,0,8863
14,JALISCO,3,TEPATITLAN DE MORELOS,53,JUANACATLAN,1695,1046,993,0,2039,1039,982,0,2021
14,JALISCO,3,TEPATITLAN DE MORELOS,62,MEXTICACAN,1824,685,792,0,1477,668,775,0,1443
14,JALISCO,3,TEPATITLAN DE MORELOS,62,MEXTICACAN,1825,408,478,0,886,401,474,0,875
14,JALISCO,3,TEPATITLAN DE MORELOS,62,MEXTICACAN,1826,285,293,0,578,277,285,0,562
14,JALISCO,3,TEPATITLAN DE MORELOS,62,MEXTICACAN,1827,269,344,0,613,260,338,0,598
14,JALISCO,3,TEPATITLAN DE MORELOS,62,MEXTICACAN,1828,422,428,0,850,413,420,0,833
14,JALISCO,3,TEPATITLAN DE MORELOS,62,MEXTICACAN,1829,305,353,0,658,300,349,0,649
14,JALISCO,3,TEPATITLAN DE MORELOS,62,MEXTICACAN,1830,91,104,0,195,90,103,0,193
14,JALISCO,3,TEPATITLAN DE MORELOS,94,TEPATITLAN DE MORELOS,2340,1437,1463,0,2900,1421,1446,0,2867
14,JALISCO,3,TEPATITLAN DE MORELOS,94,TEPATITLAN DE MORELOS,2341,1426,1602,0,3028,1407,1590,0,2997
14,JALISCO,3,TEPATITLAN DE MORELOS,94,TEPATITLAN DE MORELOS,2342,1325,1365,0,2690,1311,1351,0,2662
14,JALISCO,3,TEPATITLAN DE MORELOS,94,TEPATITLAN DE MORELOS,2343,1487,1533,0,3020,1472,1521,0,2993
14,JALISCO,3,TEPATITLAN DE MORELOS,94,TEPATITLAN DE MORELOS,2344,3191,3426,0,6617,3164,3407,0,6571
14,JALISCO,3,TEPATITLAN DE MORELOS,94,TEPATITLAN DE MORELOS,2345,680,840,0,1520,675,835,0,1510
14,JALISCO,3,TEPATITLAN DE MORELOS,94,TEPATITLAN DE MORELOS,2346,1073,1130,0,2203,1063,1120,0,2183
14,JALISCO,3,TEPATITLAN DE MORELOS,94,TEPATITLAN DE MORELOS,2347,782,844,0,1626,766,836,0,1602
14,JALISCO,3,TEPATITLAN DE MORELOS,94,TEPATITLAN DE MORELOS,2348,1038,1133,0,2171,1028,1124,0,2152
14,JALISCO,3,TEPATITLAN DE MORELOS,94,TEPATITLAN DE MORELOS,2349,580,652,0,1232,572,646,0,1218
14,JALISCO,3,TEPATITLAN DE MORELOS,94,TEPATITLAN DE MORELOS,2350,585,694,0,1279,580,689,0,1269
14,JALISCO,3,TEPATITLAN DE MORELOS,94,TEPATITLAN DE MORELOS,2351,1882,1980,0,3862,1864,1957,0,3821
14,JALISCO,3,TEPATITLAN DE MORELOS,94,TEPATITLAN DE MORELOS,2352,2851,3018,0,5869,2833,2980,0,5813
14,JALISCO,3,TEPATITLAN DE MORELOS,94,TEPATITLAN DE MORELOS,2353,1614,1653,0,3267,1592,1632,0,3224
14,JALISCO,3,TEPATITLAN DE MORELOS,94,TEPATITLAN DE MORELOS,2354,1137,1240,0,2377,1123,1228,0,2351
14,JALISCO,3,TEPATITLAN DE MORELOS,94,TEPATITLAN DE MORELOS,2355,856,936,0,1792,844,927,0,1771
14,JALISCO,3,TEPATITLAN DE MORELOS,94,TEPATITLAN DE MORELOS,2356,980,1067,0,2047,970,1052,0,2022
14,JALISCO,3,TEPATITLAN DE MORELOS,94,TEPATITLAN DE MORELOS,2357,3230,3395,0,6625,3203,3365,0,6568
14,JALISCO,3,TEPATITLAN DE MORELOS,94,TEPATITLAN DE MORELOS,2358,858,978,0,1836,852,966,0,1818
14,JALISCO,3,TEPATITLAN DE MORELOS,94,TEPATITLAN DE MORELOS,2359,815,933,0,1748,807,923,0,1730
14,JALISCO,3,TEPATITLAN DE MORELOS,94,TEPATITLAN DE MORELOS,2362,2278,2358,0,4636,2259,2337,0,4596
14,JALISCO,3,TEPATITLAN DE MORELOS,94,TEPATITLAN DE MORELOS,2363,2007,2050,0,4057,1990,2031,0,4021
14,JALISCO,3,TEPATITLAN DE MORELOS,94,TEPATITLAN DE MORELOS,2364,3413,3456,0,6869,3381,3421,0,6802
14,JALISCO,3,TEPATITLAN DE MORELOS,94,TEPATITLAN DE MORELOS,2365,819,894,0,1713,797,878,0,1675
14,JALISCO,3,TEPATITLAN DE MORELOS,94,TEPATITLAN DE MORELOS,2366,1026,1112,0,2138,1008,1090,0,2098
14,JALISCO,3,TEPATITLAN DE MORELOS,94,TEPATITLAN DE MORELOS,2367,941,947,0,1888,927,935,0,1862
14,JALISCO,3,TEPATITLAN DE MORELOS,94,TEPATITLAN DE MORELOS,2368,311,369,0,680,308,361,0,669
14,JALISCO,3,TEPATITLAN DE MORELOS,94,TEPATITLAN DE MORELOS,2369,1426,1527,0,2953,1410,1513,0,2923
14,JALISCO,3,TEPATITLAN DE MORELOS,94,TEPATITLAN DE MORELOS,2370,1462,1589,0,3051,1438,1574,0,3012
14,JALISCO,3,TEPATITLAN DE MORELOS,94,TEPATITLAN DE MORELOS,2371,2110,2251,0,4361,2091,2235,0,4326
14,JALISCO,3,TEPATITLAN DE MORELOS,94,TEPATITLAN DE MORELOS,2372,1427,1459,0,2886,1406,1440,0,2846
14,JALISCO,3,TEPATITLAN DE MORELOS,94,TEPATITLAN DE MORELOS,2373,961,1087,0,2048,949,1079,0,2028
14,JALISCO,3,TEPATITLAN DE MORELOS,94,TEPATITLAN DE MORELOS,2374,708,814,0,1522,700,805,0,1505
14,JALISCO,3,TEPATITLAN DE MORELOS,94,TEPATITLAN DE MORELOS,2375,966,999,0,1965,955,988,0,1943
14,JALISCO,3,TEPATITLAN DE MORELOS,94,TEPATITLAN DE MORELOS,2377,116,124,0,240,116,124,0,240
14,JALISCO,3,TEPATITLAN DE MORELOS,94,TEPATITLAN DE MORELOS,2378,565,506,0,1071,559,504,0,1063
14,JALISCO,3,TEPATITLAN DE MORELOS,94,TEPATITLAN DE MORELOS,2379,83,67,0,150,82,66,0,148
14,JALISCO,3,TEPATITLAN DE MORELOS,94,TEPATITLAN DE MORELOS,2380,84,70,0,154,84,70,0,154
14,JALISCO,3,TEPATITLAN DE MORELOS,94,TEPATITLAN DE MORELOS,2381,1043,994,0,2037,1032,983,0,2015
14,JALISCO,3,TEPATITLAN DE MORELOS,94,TEPATITLAN DE MORELOS,2382,526,494,0,1020,524,491,0,1015
14,JALISCO,3,TEPATITLAN DE MORELOS,94,TEPATITLAN DE MORELOS,2383,750,750,0,1500,742,746,0,1488
14,JALISCO,3,TEPATITLAN DE MORELOS,94,TEPATITLAN DE MORELOS,2384,310,295,0,605,305,292,0,597
14,JALISCO,3,TEPATITLAN DE MORELOS,94,TEPATITLAN DE MORELOS,2385,300,281,0,581,296,279,0,575
14,JALISCO,3,TEPATITLAN DE MORELOS,94,TEPATITLAN DE MORELOS,2386,289,249,0,538,287,243,0,530
14,JALISCO,3,TEPATITLAN DE MORELOS,94,TEPATITLAN DE MORELOS,2387,208,237,0,445,205,236,0,441
14,JALISCO,3,TEPATITLAN DE MORELOS,94,TEPATITLAN DE MORELOS,2388,300,309,0,609,299,306,0,605
14,JALISCO,3,TEPATITLAN DE MORELOS,94,TEPATITLAN DE MORELOS,2389,1333,1379,0,2712,1315,1353,0,2668
14,JALISCO,3,TEPATITLAN DE MORELOS,94,TEPATITLAN DE MORELOS,2390,273,282,0,555,270,281,0,551
14,JALISCO,3,TEPATITLAN DE MORELOS,94,TEPATITLAN DE MORELOS,2392,947,936,0,1883,945,930,0,1875
14,JALISCO,3,TEPATITLAN DE MORELOS,94,TEPATITLAN DE MORELOS,2393,316,292,0,608,314,289,0,603
14,JALISCO,3,TEPATITLAN DE MORELOS,94,TEPATITLAN DE MORELOS,2394,419,415,0,834,415,414,0,829
14,JALISCO,3,TEPATITLAN DE MORELOS,94,TEPATITLAN DE MORELOS,2395,543,588,0,1131,535,577,0,1112
14,JALISCO,3,TEPATITLAN DE MORELOS,94,TEPATITLAN DE MORELOS,3671,292,303,0,595,291,299,0,590
14,JALISCO,3,TEPATITLAN DE MORELOS,94,TEPATITLAN DE MORELOS,3672,449,423,0,872,448,422,0,870
14,JALISCO,3,TEPATITLAN DE MORELOS,94,TEPATITLAN DE MORELOS,3673,760,693,0,1453,754,691,0,1445
14,JALISCO,3,TEPATITLAN DE MORELOS,94,TEPATITLAN DE MORELOS,3674,464,444,0,908,458,442,0,900
14,JALISCO,3,TEPATITLAN DE MORELOS,94,TEPATITLAN DE MORELOS,3766,952,934,0,1886,945,934,0,1879
14,JALISCO,3,TEPATITLAN DE MORELOS,94,TEPATITLAN DE MORELOS,3767,809,897,0,1706,804,889,0,1693
14,JALISCO,3,TEPATITLAN DE MORELOS,94,TEPATITLAN DE MORELOS,3768,1042,1059,0,2101,1030,1039,0,2069
14,JALISCO,3,TEPATITLAN DE MORELOS,94,TEPATITLAN DE MORELOS,3769,1023,1108,0,2131,1013,1094,0,2107
14,JALISCO,3,TEPATITLAN DE MORELOS,94,TEPATITLAN DE MORELOS,3770,1132,1228,0,2360,1128,1217,0,2345
14,JALISCO,3,TEPATITLAN DE MORELOS,94,TEPATITLAN DE MORELOS,3771,812,870,0,1682,809,868,0,1677
14,JALISCO,3,TEPATITLAN DE MORELOS,94,TEPATITLAN DE MORELOS,3772,1004,1028,0,2032,991,1019,0,2010
14,JALISCO,3,TEPATITLAN DE MORELOS,94,TEPATITLAN DE MORELOS,3773,617,661,0,1278,610,653,0,1263
14,JALISCO,3,TEPATITLAN DE MORELOS,106,TOTOTLAN,2748,1027,1068,0,2095,1006,1046,0,2052
14,JALISCO,3,TEPATITLAN DE MORELOS,106,TOTOTLAN,2749,2165,2326,0,4491,2122,2274,0,4396
14,JALISCO,3,TEPATITLAN DE MORELOS,106,TOTOTLAN,2750,1150,1214,0,2364,1127,1182,0,2309
14,JALISCO,3,TEPATITLAN DE MORELOS,106,TOTOTLAN,2751,831,945,0,1776,813,926,0,1739
14,JALISCO,3,TEPATITLAN DE MORELOS,106,TOTOTLAN,2752,594,638,0,1232,587,631,0,1218
14,JALISCO,3,TEPATITLAN DE MORELOS,106,TOTOTLAN,2753,336,348,0,684,332,345,0,677
14,JALISCO,3,TEPATITLAN DE MORELOS,106,TOTOTLAN,2754,244,226,0,470,241,225,0,466
14,JALISCO,3,TEPATITLAN DE MORELOS,106,TOTOTLAN,2755,272,262,0,534,265,255,0,520
14,JALISCO,3,TEPATITLAN DE MORELOS,106,TOTOTLAN,2756,670,683,0,1353,656,672,0,1328
14,JALISCO,3,TEPATITLAN DE MORELOS,106,TOTOTLAN,2757,494,442,0,936,489,432,0,921
14,JALISCO,3,TEPATITLAN DE MORELOS,106,TOTOTLAN,2758,272,283,0,555,271,275,0,546
14,JALISCO,3,TEPATITLAN DE MORELOS,106,TOTOTLAN,2759,584,644,0,1228,576,634,0,1210
14,JALISCO,3,TEPATITLAN DE MORELOS,106,TOTOTLAN,2760,266,257,0,523,262,254,0,516
14,JALISCO,3,TEPATITLAN DE MORELOS,106,TOTOTLAN,2761,725,777,0,1502,715,768,0,1483
14,JALISCO,3,TEPATITLAN DE MORELOS,112,VALLE DE GUADALUPE,2816,1584,1668,0,3252,1528,1619,0,3147
14,JALISCO,3,TEPATITLAN DE MORELOS,112,VALLE DE GUADALUPE,2817,650,710,0,1360,638,687,0,1325
14,JALISCO,3,TEPATITLAN DE MORELOS,112,VALLE DE GUADALUPE,2818,653,698,0,1351,636,684,0,1320
14,JALISCO,3,TEPATITLAN DE MORELOS,112,VALLE DE GUADALUPE,2819,117,121,0,238,116,119,0,235
14,JALISCO,3,TEPATITLAN DE MORELOS,112,VALLE DE GUADALUPE,2820,228,219,0,447,226,218,0,444
14,JALISCO,3,TEPATITLAN DE MORELOS,112,VALLE DE GUADALUPE,2821,125,115,0,240,125,114,0,239
14,JALISCO,3,TEPATITLAN DE MORELOS,112,VALLE DE GUADALUPE,2823,181,163,0,344,179,160,0,339
14,JALISCO,3,TEPATITLAN DE MORELOS,117,CAÐADAS DE OBREGON,2855,486,427,0,913,473,415,0,888
14,JALISCO,3,TEPATITLAN DE MORELOS,117,CAÐADAS DE OBREGON,2856,684,719,0,1403,658,688,0,1346
14,JALISCO,3,TEPATITLAN DE MORELOS,117,CAÐADAS DE OBREGON,2857,410,431,0,841,399,421,0,820
14,JALISCO,3,TEPATITLAN DE MORELOS,117,CAÐADAS DE OBREGON,2858,313,329,0,642,307,327,0,634
14,JALISCO,3,TEPATITLAN DE MORELOS,117,CAÐADAS DE OBREGON,2859,60,65,0,125,60,65,0,125
14,JALISCO,3,TEPATITLAN DE MORELOS,117,CAÐADAS DE OBREGON,2860,102,87,0,189,100,85,0,185
14,JALISCO,3,TEPATITLAN DE MORELOS,117,CAÐADAS DE OBREGON,2861,109,80,0,189,108,78,0,186
14,JALISCO,3,TEPATITLAN DE MORELOS,118,YAHUALICA DE GONZALEZ GALLO,2862,629,689,0,1318,617,674,0,1291
14,JALISCO,3,TEPATITLAN DE MORELOS,118,YAHUALICA DE GONZALEZ GALLO,2863,479,560,0,1039,471,553,0,1024
14,JALISCO,3,TEPATITLAN DE MORELOS,118,YAHUALICA DE GONZALEZ GALLO,2864,423,525,0,948,415,521,0,936
14,JALISCO,3,TEPATITLAN DE MORELOS,118,YAHUALICA DE GONZALEZ GALLO,2865,643,726,0,1369,633,714,0,1347
14,JALISCO,3,TEPATITLAN DE MORELOS,118,YAHUALICA DE GONZALEZ GALLO,2866,304,316,0,620,300,310,0,610
14,JALISCO,3,TEPATITLAN DE MORELOS,118,YAHUALICA DE GONZALEZ GALLO,2867,895,1046,0,1941,876,1032,0,1908
14,JALISCO,3,TEPATITLAN DE MORELOS,118,YAHUALICA DE GONZALEZ GALLO,2868,762,896,0,1658,749,884,0,1633
14,JALISCO,3,TEPATITLAN DE MORELOS,118,YAHUALICA DE GONZALEZ GALLO,2869,933,1054,0,1987,917,1042,0,1959
14,JALISCO,3,TEPATITLAN DE MORELOS,118,YAHUALICA DE GONZALEZ GALLO,2870,650,701,0,1351,641,693,0,1334
14,JALISCO,3,TEPATITLAN DE MORELOS,118,YAHUALICA DE GONZALEZ GALLO,2871,1508,1566,0,3074,1496,1550,0,3046
14,JALISCO,3,TEPATITLAN DE MORELOS,118,YAHUALICA DE GONZALEZ GALLO,2873,147,156,0,303,147,156,0,303
14,JALISCO,3,TEPATITLAN DE MORELOS,118,YAHUALICA DE GONZALEZ GALLO,2874,167,205,0,372,165,196,0,361
14,JALISCO,3,TEPATITLAN DE MORELOS,118,YAHUALICA DE GONZALEZ GALLO,2875,536,559,0,1095,518,540,0,1058
14,JALISCO,3,TEPATITLAN DE MORELOS,118,YAHUALICA DE GONZALEZ GALLO,2876,181,202,0,383,179,201,0,380
14,JALISCO,3,TEPATITLAN DE MORELOS,118,YAHUALICA DE GONZALEZ GALLO,2877,102,127,0,229,101,123,0,224
14,JALISCO,3,TEPATITLAN DE MORELOS,118,YAHUALICA DE GONZALEZ GALLO,2878,835,948,0,1783,826,933,0,1759
14,JALISCO,3,TEPATITLAN DE MORELOS,118,YAHUALICA DE GONZALEZ GALLO,2879,378,416,0,794,375,413,0,788
14,JALISCO,3,TEPATITLAN DE MORELOS,118,YAHUALICA DE GONZALEZ GALLO,2881,272,311,0,583,269,303,0,572
14,JALISCO,3,TEPATITLAN DE MORELOS,118,YAHUALICA DE GONZALEZ GALLO,2882,140,129,0,269,139,128,0,267
14,JALISCO,3,TEPATITLAN DE MORELOS,118,YAHUALICA DE GONZALEZ GALLO,2883,209,191,0,400,204,187,0,391
14,JALISCO,3,TEPATITLAN DE MORELOS,123,ZAPOTLAN DEL REY,3265,831,873,0,1704,816,859,0,1675
14,JALISCO,3,TEPATITLAN DE MORELOS,123,ZAPOTLAN DEL REY,3266,864,856,0,1720,850,849,0,1699
14,JALISCO,3,TEPATITLAN DE MORELOS,123,ZAPOTLAN DEL REY,3267,502,498,0,1000,498,488,0,986
14,JALISCO,3,TEPATITLAN DE MORELOS,123,ZAPOTLAN DEL REY,3268,179,175,0,354,176,173,0,349
14,JALISCO,3,TEPATITLAN DE MORELOS,123,ZAPOTLAN DEL REY,3269,466,431,0,897,464,428,0,892
14,JALISCO,3,TEPATITLAN DE MORELOS,123,ZAPOTLAN DEL REY,3270,292,285,0,577,289,280,0,569
14,JALISCO,3,TEPATITLAN DE MORELOS,123,ZAPOTLAN DEL REY,3271,603,605,0,1208,596,600,0,1196
14,JALISCO,3,TEPATITLAN DE MORELOS,123,ZAPOTLAN DEL REY,3272,598,594,0,1192,594,589,0,1183
14,JALISCO,3,TEPATITLAN DE MORELOS,123,ZAPOTLAN DEL REY,3273,753,756,0,1509,743,754,0,1497
14,JALISCO,3,TEPATITLAN DE MORELOS,123,ZAPOTLAN DEL REY,3274,255,258,0,513,250,256,0,506
14,JALISCO,3,TEPATITLAN DE MORELOS,123,ZAPOTLAN DEL REY,3275,871,883,0,1754,865,876,0,1741
14,JALISCO,3,TEPATITLAN DE MORELOS,123,ZAPOTLAN DEL REY,3276,933,981,0,1914,924,975,0,1899
14,JALISCO,3,TEPATITLAN DE MORELOS,123,ZAPOTLAN DEL REY,3277,613,620,0,1233,606,617,0,1223
14,JALISCO,3,TEPATITLAN DE MORELOS,124,ZAPOTLANEJO,3278,1841,1998,0,3839,1826,1980,0,3806
14,JALISCO,3,TEPATITLAN DE MORELOS,124,ZAPOTLANEJO,3279,1043,1160,0,2203,1027,1144,0,2171
14,JALISCO,3,TEPATITLAN DE MORELOS,124,ZAPOTLANEJO,3280,1027,1135,0,2162,1006,1115,0,2121
14,JALISCO,3,TEPATITLAN DE MORELOS,124,ZAPOTLANEJO,3281,894,1067,0,1961,878,1054,0,1932
14,JALISCO,3,TEPATITLAN DE MORELOS,124,ZAPOTLANEJO,3282,1402,1497,0,2899,1391,1486,0,2877
14,JALISCO,3,TEPATITLAN DE MORELOS,124,ZAPOTLANEJO,3283,1971,2166,0,4137,1950,2148,0,4098
14,JALISCO,3,TEPATITLAN DE MORELOS,124,ZAPOTLANEJO,3284,729,729,0,1458,728,725,0,1453
14,JALISCO,3,TEPATITLAN DE MORELOS,124,ZAPOTLANEJO,3285,1100,1158,0,2258,1086,1153,0,2239
14,JALISCO,3,TEPATITLAN DE MORELOS,124,ZAPOTLANEJO,3286,723,787,0,1510,712,774,0,1486
14,JALISCO,3,TEPATITLAN DE MORELOS,124,ZAPOTLANEJO,3287,700,727,0,1427,690,709,0,1399
14,JALISCO,3,TEPATITLAN DE MORELOS,124,ZAPOTLANEJO,3288,1303,1336,0,2639,1288,1324,0,2612
14,JALISCO,3,TEPATITLAN DE MORELOS,124,ZAPOTLANEJO,3289,2197,2379,0,4576,2176,2353,0,4529
14,JALISCO,3,TEPATITLAN DE MORELOS,124,ZAPOTLANEJO,3290,418,413,0,831,416,411,0,827
14,JALISCO,3,TEPATITLAN DE MORELOS,124,ZAPOTLANEJO,3291,923,996,0,1919,916,986,0,1902
14,JALISCO,3,TEPATITLAN DE MORELOS,124,ZAPOTLANEJO,3292,195,155,0,350,192,152,0,344
14,JALISCO,3,TEPATITLAN DE MORELOS,124,ZAPOTLANEJO,3293,221,215,0,436,217,213,0,430
14,JALISCO,3,TEPATITLAN DE MORELOS,124,ZAPOTLANEJO,3294,446,427,0,873,441,421,0,862
14,JALISCO,3,TEPATITLAN DE MORELOS,124,ZAPOTLANEJO,3295,652,684,0,1336,643,673,0,1316
14,JALISCO,3,TEPATITLAN DE MORELOS,124,ZAPOTLANEJO,3296,368,364,0,732,363,361,0,724
14,JALISCO,3,TEPATITLAN DE MORELOS,124,ZAPOTLANEJO,3297,656,646,0,1302,652,643,0,1295
14,JALISCO,3,TEPATITLAN DE MORELOS,124,ZAPOTLANEJO,3298,519,466,0,985,516,460,0,976
14,JALISCO,3,TEPATITLAN DE MORELOS,124,ZAPOTLANEJO,3299,165,141,0,306,163,140,0,303
14,JALISCO,3,TEPATITLAN DE MORELOS,124,ZAPOTLANEJO,3300,282,266,0,548,279,261,0,540
14,JALISCO,3,TEPATITLAN DE MORELOS,124,ZAPOTLANEJO,3301,2221,2377,0,4598,2197,2344,0,4541
14,JALISCO,3,TEPATITLAN DE MORELOS,124,ZAPOTLANEJO,3302,2237,2333,0,4570,2210,2308,0,4518
14,JALISCO,3,TEPATITLAN DE MORELOS,124,ZAPOTLANEJO,3303,735,700,0,1435,727,694,0,1421
14,JALISCO,3,TEPATITLAN DE MORELOS,124,ZAPOTLANEJO,3304,600,577,0,1177,593,574,0,1167
14,JALISCO,3,TEPATITLAN DE MORELOS,124,ZAPOTLANEJO,3305,583,564,0,1147,579,559,0,1138
14,JALISCO,3,TEPATITLAN DE MORELOS,124,ZAPOTLANEJO,3306,884,863,0,1747,873,852,0,1725
14,JALISCO,3,TEPATITLAN DE MORELOS,124,ZAPOTLANEJO,3307,875,911,0,1786,868,900,0,1768
14,JALISCO,3,TEPATITLAN DE MORELOS,124,ZAPOTLANEJO,3308,932,964,0,1896,924,954,0,1878
14,JALISCO,3,TEPATITLAN DE MORELOS,124,ZAPOTLANEJO,3309,1378,1471,0,2849,1366,1456,0,2822
14,JALISCO,3,TEPATITLAN DE MORELOS,125,SAN IGNACIO CERRO GORDO,120,1115,1267,0,2382,1105,1253,0,2358
14,JALISCO,3,TEPATITLAN DE MORELOS,125,SAN IGNACIO CERRO GORDO,121,835,891,0,1726,827,887,0,1714
14,JALISCO,3,TEPATITLAN DE MORELOS,125,SAN IGNACIO CERRO GORDO,122,1319,1478,0,2797,1308,1470,0,2778
14,JALISCO,3,TEPATITLAN DE MORELOS,125,SAN IGNACIO CERRO GORDO,123,1470,1605,0,3075,1456,1584,0,3040
14,JALISCO,3,TEPATITLAN DE MORELOS,125,SAN IGNACIO CERRO GORDO,135,389,401,0,790,383,400,0,783
14,JALISCO,3,TEPATITLAN DE MORELOS,125,SAN IGNACIO CERRO GORDO,136,992,1063,0,2055,980,1056,0,2036
14,JALISCO,3,TEPATITLAN DE MORELOS,125,SAN IGNACIO CERRO GORDO,138,1082,1122,0,2204,1069,1109,0,2178
14,JALISCO,3,TEPATITLAN DE MORELOS,125,SAN IGNACIO CERRO GORDO,3357,538,575,0,1113,533,571,0,1104
14,JALISCO,4,ZAPOPAN,120,ZAPOPAN,2906,825,901,0,1726,817,888,0,1705
14,JALISCO,4,ZAPOPAN,120,ZAPOPAN,2907,747,726,0,1473,737,718,0,1455
14,JALISCO,4,ZAPOPAN,120,ZAPOPAN,2908,788,857,0,1645,781,846,0,1627
14,JALISCO,4,ZAPOPAN,120,ZAPOPAN,2909,708,771,0,1479,701,758,0,1459
14,JALISCO,4,ZAPOPAN,120,ZAPOPAN,2910,829,885,0,1714,818,875,0,1693
14,JALISCO,4,ZAPOPAN,120,ZAPOPAN,2911,836,908,0,1744,824,900,0,1724
14,JALISCO,4,ZAPOPAN,120,ZAPOPAN,2912,587,628,0,1215,581,624,0,1205
14,JALISCO,4,ZAPOPAN,120,ZAPOPAN,2913,630,695,0,1325,621,685,0,1306
14,JALISCO,4,ZAPOPAN,120,ZAPOPAN,2914,412,446,0,858,406,439,0,845
14,JALISCO,4,ZAPOPAN,120,ZAPOPAN,2916,543,566,0,1109,540,556,0,1096
14,JALISCO,4,ZAPOPAN,120,ZAPOPAN,2917,934,978,0,1912,922,970,0,1892
14,JALISCO,4,ZAPOPAN,120,ZAPOPAN,2918,838,1006,0,1844,833,1000,0,1833
14,JALISCO,4,ZAPOPAN,120,ZAPOPAN,2919,542,569,0,1111,540,565,0,1105
14,JALISCO,4,ZAPOPAN,120,ZAPOPAN,2920,826,887,0,1713,822,878,0,1700
14,JALISCO,4,ZAPOPAN,120,ZAPOPAN,2921,736,807,0,1543,729,796,0,1525
14,JALISCO,4,ZAPOPAN,120,ZAPOPAN,2922,681,699,0,1380,676,692,0,1368
14,JALISCO,4,ZAPOPAN,120,ZAPOPAN,2923,654,666,0,1320,653,656,0,1309
14,JALISCO,4,ZAPOPAN,120,ZAPOPAN,2924,714,818,0,1532,707,816,0,1523
14,JALISCO,4,ZAPOPAN,120,ZAPOPAN,2925,590,679,0,1269,585,672,0,1257
14,JALISCO,4,ZAPOPAN,120,ZAPOPAN,2926,693,780,0,1473,686,773,0,1459
14,JALISCO,4,ZAPOPAN,120,ZAPOPAN,2927,485,527,0,1012,480,525,0,1005
14,JALISCO,4,ZAPOPAN,120,ZAPOPAN,2928,601,724,0,1325,595,721,0,1316
14,JALISCO,4,ZAPOPAN,120,ZAPOPAN,2929,854,1004,0,1858,847,995,0,1842
14,JALISCO,4,ZAPOPAN,120,ZAPOPAN,2930,1110,1270,0,2380,1104,1263,0,2367
14,JALISCO,4,ZAPOPAN,120,ZAPOPAN,2931,999,1082,0,2081,989,1075,0,2064
14,JALISCO,4,ZAPOPAN,120,ZAPOPAN,2932,920,1002,0,1922,909,993,0,1902
14,JALISCO,4,ZAPOPAN,120,ZAPOPAN,2933,1396,1616,0,3012,1378,1605,0,2983
14,JALISCO,4,ZAPOPAN,120,ZAPOPAN,2934,877,983,0,1860,877,975,0,1852
14,JALISCO,4,ZAPOPAN,120,ZAPOPAN,2935,648,841,0,1489,640,836,0,1476
14,JALISCO,4,ZAPOPAN,120,ZAPOPAN,2936,479,628,0,1107,475,625,0,1100
14,JALISCO,4,ZAPOPAN,120,ZAPOPAN,2937,545,590,0,1135,544,586,0,1130
14,JALISCO,4,ZAPOPAN,120,ZAPOPAN,2938,894,941,0,1835,890,930,0,1820
14,JALISCO,4,ZAPOPAN,120,ZAPOPAN,2939,702,733,0,1435,695,726,0,1421
14,JALISCO,4,ZAPOPAN,120,ZAPOPAN,2940,814,837,0,1651,811,825,0,1636
14,JALISCO,4,ZAPOPAN,120,ZAPOPAN,2941,773,872,0,1645,765,866,0,1631
14,JALISCO,4,ZAPOPAN,120,ZAPOPAN,2942,818,852,0,1670,810,847,0,1657
14,JALISCO,4,ZAPOPAN,120,ZAPOPAN,2943,884,957,0,1841,876,947,0,1823
14,JALISCO,4,ZAPOPAN,120,ZAPOPAN,2944,366,420,0,786,364,417,0,781
14,JALISCO,4,ZAPOPAN,120,ZAPOPAN,2945,1087,1199,0,2286,1083,1191,0,2274
14,JALISCO,4,ZAPOPAN,120,ZAPOPAN,2946,1097,1126,0,2223,1089,1115,0,2204
14,JALISCO,4,ZAPOPAN,120,ZAPOPAN,2947,740,786,0,1526,732,777,0,1509
14,JALISCO,4,ZAPOPAN,120,ZAPOPAN,2948,1242,1231,0,2473,1233,1222,0,2455
14,JALISCO,4,ZAPOPAN,120,ZAPOPAN,2949,1825,1980,0,3805,1813,1968,0,3781
14,JALISCO,4,ZAPOPAN,120,ZAPOPAN,2950,1310,1397,0,2707,1301,1385,0,2686
14,JALISCO,4,ZAPOPAN,120,ZAPOPAN,2951,749,796,0,1545,740,783,0,1523
14,JALISCO,4,ZAPOPAN,120,ZAPOPAN,2952,728,741,0,1469,722,731,0,1453
14,JALISCO,4,ZAPOPAN,120,ZAPOPAN,2953,938,1035,0,1973,926,1028,0,1954
14,JALISCO,4,ZAPOPAN,120,ZAPOPAN,2954,996,1088,0,2084,989,1076,0,2065
14,JALISCO,4,ZAPOPAN,120,ZAPOPAN,2955,864,901,0,1765,853,893,0,1746
14,JALISCO,4,ZAPOPAN,120,ZAPOPAN,2956,773,833,0,1606,766,827,0,1593
14,JALISCO,4,ZAPOPAN,120,ZAPOPAN,2957,487,623,0,1110,483,613,0,1096
14,JALISCO,4,ZAPOPAN,120,ZAPOPAN,2958,543,539,1,1083,539,531,1,1071
14,JALISCO,4,ZAPOPAN,120,ZAPOPAN,2959,521,565,0,1086,516,560,0,1076
14,JALISCO,4,ZAPOPAN,120,ZAPOPAN,2960,1020,1025,0,2045,1012,1015,0,2027
14,JALISCO,4,ZAPOPAN,120,ZAPOPAN,2961,1001,1033,0,2034,985,1023,0,2008
14,JALISCO,4,ZAPOPAN,120,ZAPOPAN,2962,1089,1243,0,2332,1083,1235,0,2318
14,JALISCO,4,ZAPOPAN,120,ZAPOPAN,2963,383,431,0,814,380,424,0,804
14,JALISCO,4,ZAPOPAN,120,ZAPOPAN,2965,1023,1084,0,2107,1015,1066,0,2081
14,JALISCO,4,ZAPOPAN,120,ZAPOPAN,2966,1542,1695,0,3237,1531,1683,0,3214
14,JALISCO,4,ZAPOPAN,120,ZAPOPAN,2967,745,851,0,1596,738,845,0,1583
14,JALISCO,4,ZAPOPAN,120,ZAPOPAN,2968,1175,1291,0,2466,1169,1283,0,2452
14,JALISCO,4,ZAPOPAN,120,ZAPOPAN,2970,963,1051,0,2014,956,1040,0,1996
14,JALISCO,4,ZAPOPAN,120,ZAPOPAN,2971,559,622,1,1182,557,619,1,1177
14,JALISCO,4,ZAPOPAN,120,ZAPOPAN,2972,1087,1234,0,2321,1079,1220,0,2299
14,JALISCO,4,ZAPOPAN,120,ZAPOPAN,2973,737,799,0,1536,729,795,0,1524
14,JALISCO,4,ZAPOPAN,120,ZAPOPAN,2974,759,850,0,1609,754,843,0,1597
14,JALISCO,4,ZAPOPAN,120,ZAPOPAN,2975,893,1000,0,1893,887,990,0,1877
14,JALISCO,4,ZAPOPAN,120,ZAPOPAN,2977,633,728,0,1361,627,721,0,1348
14,JALISCO,4,ZAPOPAN,120,ZAPOPAN,2978,546,588,0,1134,544,582,0,1126
14,JALISCO,4,ZAPOPAN,120,ZAPOPAN,2979,1661,1753,0,3414,1648,1734,0,3382
14,JALISCO,4,ZAPOPAN,120,ZAPOPAN,2980,1035,1170,0,2205,1022,1162,0,2184
14,JALISCO,4,ZAPOPAN,120,ZAPOPAN,2981,1239,1393,0,2632,1229,1381,0,2610
14,JALISCO,4,ZAPOPAN,120,ZAPOPAN,2982,857,936,1,1794,851,930,1,1782
14,JALISCO,4,ZAPOPAN,120,ZAPOPAN,2983,1651,1630,0,3281,1637,1618,0,3255
14,JALISCO,4,ZAPOPAN,120,ZAPOPAN,2984,1458,1586,0,3044,1444,1576,0,3020
14,JALISCO,4,ZAPOPAN,120,ZAPOPAN,2985,2205,2355,0,4560,2180,2334,0,4514
14,JALISCO,4,ZAPOPAN,120,ZAPOPAN,2986,1463,1557,0,3020,1453,1533,0,2986
14,JALISCO,4,ZAPOPAN,120,ZAPOPAN,2987,1508,1670,0,3178,1489,1643,0,3132
14,JALISCO,4,ZAPOPAN,120,ZAPOPAN,2988,932,973,0,1905,919,965,0,1884
14,JALISCO,4,ZAPOPAN,120,ZAPOPAN,2989,2231,2559,1,4791,2206,2547,1,4754
14,JALISCO,4,ZAPOPAN,120,ZAPOPAN,2990,799,905,0,1704,785,898,0,1683
14,JALISCO,4,ZAPOPAN,120,ZAPOPAN,2991,1074,1093,0,2167,1065,1081,0,2146
14,JALISCO,4,ZAPOPAN,120,ZAPOPAN,2992,1105,1141,0,2246,1094,1130,0,2224
14,JALISCO,4,ZAPOPAN,120,ZAPOPAN,2993,4263,4371,1,8635,4224,4335,1,8560
14,JALISCO,4,ZAPOPAN,120,ZAPOPAN,2994,1216,1288,0,2504,1208,1279,0,2487
14,JALISCO,4,ZAPOPAN,120,ZAPOPAN,2995,1105,1141,0,2246,1094,1133,0,2227
14,JALISCO,4,ZAPOPAN,120,ZAPOPAN,2996,1228,1192,0,2420,1217,1187,0,2404
14,JALISCO,4,ZAPOPAN,120,ZAPOPAN,2997,733,755,0,1488,729,746,0,1475
14,JALISCO,4,ZAPOPAN,120,ZAPOPAN,2998,1048,1051,0,2099,1040,1045,0,2085
14,JALISCO,4,ZAPOPAN,120,ZAPOPAN,2999,1238,1247,0,2485,1224,1239,0,2463
14,JALISCO,4,ZAPOPAN,120,ZAPOPAN,3000,1770,1837,0,3607,1753,1818,0,3571
14,JALISCO,4,ZAPOPAN,120,ZAPOPAN,3001,3564,3607,0,7171,3522,3575,0,7097
14,JALISCO,4,ZAPOPAN,120,ZAPOPAN,3002,2167,2217,0,4384,2147,2203,0,4350
14,JALISCO,4,ZAPOPAN,120,ZAPOPAN,3003,1682,1780,0,3462,1667,1762,0,3429
14,JALISCO,4,ZAPOPAN,120,ZAPOPAN,3004,2203,2289,0,4492,2183,2271,0,4454
14,JALISCO,4,ZAPOPAN,120,ZAPOPAN,3005,2668,2757,0,5425,2639,2736,0,5375
14,JALISCO,4,ZAPOPAN,120,ZAPOPAN,3007,4673,4970,0,9643,4616,4936,0,9552
14,JALISCO,4,ZAPOPAN,120,ZAPOPAN,3008,2147,2195,0,4342,2128,2183,0,4311
14,JALISCO,4,ZAPOPAN,120,ZAPOPAN,3009,2432,2380,0,4812,2411,2361,0,4772
14,JALISCO,4,ZAPOPAN,120,ZAPOPAN,3010,2192,2242,0,4434,2168,2213,0,4381
14,JALISCO,4,ZAPOPAN,120,ZAPOPAN,3011,1850,1822,0,3672,1827,1805,0,3632
14,JALISCO,4,ZAPOPAN,120,ZAPOPAN,3012,2755,2832,0,5587,2730,2808,0,5538
14,JALISCO,4,ZAPOPAN,120,ZAPOPAN,3013,4587,4709,0,9296,4538,4669,0,9207
14,JALISCO,4,ZAPOPAN,120,ZAPOPAN,3014,3448,3666,0,7114,3406,3625,0,7031
14,JALISCO,4,ZAPOPAN,120,ZAPOPAN,3015,4614,4805,0,9419,4565,4763,0,9328
14,JALISCO,4,ZAPOPAN,120,ZAPOPAN,3016,2434,2416,0,4850,2405,2390,0,4795
14,JALISCO,4,ZAPOPAN,120,ZAPOPAN,3017,2937,2914,0,5851,2906,2890,0,5796
14,JALISCO,4,ZAPOPAN,120,ZAPOPAN,3073,669,691,0,1360,661,689,0,1350
14,JALISCO,4,ZAPOPAN,120,ZAPOPAN,3075,857,1039,0,1896,846,1027,0,1873
14,JALISCO,4,ZAPOPAN,120,ZAPOPAN,3076,1027,1218,0,2245,1023,1207,0,2230
14,JALISCO,4,ZAPOPAN,120,ZAPOPAN,3471,509,577,0,1086,503,577,0,1080
14,JALISCO,4,ZAPOPAN,120,ZAPOPAN,3472,358,406,1,765,357,398,1,756
14,JALISCO,4,ZAPOPAN,120,ZAPOPAN,3473,616,646,0,1262,613,642,0,1255
14,JALISCO,4,ZAPOPAN,120,ZAPOPAN,3474,252,265,0,517,250,264,0,514
14,JALISCO,4,ZAPOPAN,120,ZAPOPAN,3475,751,768,0,1519,744,766,0,1510
14,JALISCO,4,ZAPOPAN,120,ZAPOPAN,3476,642,718,0,1360,638,712,0,1350
14,JALISCO,4,ZAPOPAN,120,ZAPOPAN,3477,661,708,0,1369,655,702,0,1357
14,JALISCO,4,ZAPOPAN,120,ZAPOPAN,3478,521,581,0,1102,517,573,0,1090
14,JALISCO,4,ZAPOPAN,120,ZAPOPAN,3479,434,473,0,907,429,468,0,897
14,JALISCO,4,ZAPOPAN,120,ZAPOPAN,3480,575,699,0,1274,571,695,0,1266
14,JALISCO,4,ZAPOPAN,120,ZAPOPAN,3481,526,608,0,1134,521,601,0,1122
14,JALISCO,4,ZAPOPAN,120,ZAPOPAN,3482,542,581,0,1123,538,577,0,1115
14,JALISCO,4,ZAPOPAN,120,ZAPOPAN,3483,505,549,0,1054,501,540,0,1041
14,JALISCO,4,ZAPOPAN,120,ZAPOPAN,3484,311,373,0,684,310,372,0,682
14,JALISCO,4,ZAPOPAN,120,ZAPOPAN,3485,357,398,0,755,357,396,0,753
14,JALISCO,4,ZAPOPAN,120,ZAPOPAN,3486,438,542,0,980,435,537,0,972
14,JALISCO,4,ZAPOPAN,120,ZAPOPAN,3487,719,770,0,1489,711,762,0,1473
14,JALISCO,4,ZAPOPAN,120,ZAPOPAN,3488,655,760,0,1415,652,756,0,1408
14,JALISCO,4,ZAPOPAN,120,ZAPOPAN,3489,398,457,0,855,397,456,0,853
14,JALISCO,4,ZAPOPAN,120,ZAPOPAN,3490,263,276,0,539,263,273,0,536
14,JALISCO,4,ZAPOPAN,120,ZAPOPAN,3491,381,445,0,826,378,442,0,820
14,JALISCO,4,ZAPOPAN,120,ZAPOPAN,3492,630,703,0,1333,623,702,0,1325
14,JALISCO,4,ZAPOPAN,120,ZAPOPAN,3493,504,594,0,1098,502,590,0,1092
14,JALISCO,4,ZAPOPAN,120,ZAPOPAN,3494,369,405,0,774,363,402,0,765
14,JALISCO,4,ZAPOPAN,120,ZAPOPAN,3495,449,491,0,940,447,487,0,934
14,JALISCO,4,ZAPOPAN,120,ZAPOPAN,3528,543,592,0,1135,541,588,0,1129
14,JALISCO,4,ZAPOPAN,120,ZAPOPAN,3675,1114,1280,0,2394,1108,1273,0,2381
14,JALISCO,4,ZAPOPAN,120,ZAPOPAN,3697,721,852,0,1573,718,845,0,1563
14,JALISCO,4,ZAPOPAN,120,ZAPOPAN,3698,1287,1452,0,2739,1276,1441,0,2717
14,JALISCO,4,ZAPOPAN,120,ZAPOPAN,3699,1184,1285,0,2469,1176,1276,0,2452
14,JALISCO,4,ZAPOPAN,120,ZAPOPAN,3700,1190,1336,0,2526,1180,1321,0,2501
14,JALISCO,4,ZAPOPAN,120,ZAPOPAN,3774,1184,1254,0,2438,1173,1243,0,2416
14,JALISCO,4,ZAPOPAN,120,ZAPOPAN,3775,1217,1324,0,2541,1203,1315,0,2518
14,JALISCO,4,ZAPOPAN,120,ZAPOPAN,3776,1470,1573,0,3043,1460,1561,0,3021
14,JALISCO,4,ZAPOPAN,120,ZAPOPAN,3777,1038,1069,0,2107,1026,1058,0,2084
14,JALISCO,4,ZAPOPAN,120,ZAPOPAN,3778,1096,1095,0,2191,1089,1086,0,2175
14,JALISCO,4,ZAPOPAN,120,ZAPOPAN,3779,1021,1072,0,2093,1007,1065,0,2072
14,JALISCO,4,ZAPOPAN,120,ZAPOPAN,3780,1105,1120,0,2225,1094,1108,0,2202
14,JALISCO,4,ZAPOPAN,120,ZAPOPAN,3907,928,1013,0,1941,917,1002,0,1919
14,JALISCO,4,ZAPOPAN,120,ZAPOPAN,3908,824,868,0,1692,817,861,0,1678
14,JALISCO,4,ZAPOPAN,120,ZAPOPAN,3909,1351,1415,0,2766,1335,1400,0,2735
14,JALISCO,4,ZAPOPAN,120,ZAPOPAN,3910,1313,1496,0,2809,1304,1485,0,2789
14,JALISCO,4,ZAPOPAN,120,ZAPOPAN,3911,1390,1512,0,2902,1376,1494,0,2870
14,JALISCO,4,ZAPOPAN,120,ZAPOPAN,3912,806,845,0,1651,798,839,0,1637
14,JALISCO,5,PUERTO VALLARTA,11,ATENGO,149,469,498,0,967,451,484,0,935
14,JALISCO,5,PUERTO VALLARTA,11,ATENGO,150,426,440,0,866,414,432,0,846
14,JALISCO,5,PUERTO VALLARTA,11,ATENGO,151,150,140,0,290,146,137,0,283
14,JALISCO,5,PUERTO VALLARTA,11,ATENGO,152,262,243,0,505,245,234,0,479
14,JALISCO,5,PUERTO VALLARTA,11,ATENGO,153,1026,957,0,1983,992,921,0,1913
14,JALISCO,5,PUERTO VALLARTA,11,ATENGO,154,205,180,0,385,194,177,0,371
14,JALISCO,5,PUERTO VALLARTA,12,ATENGUILLO,155,555,590,0,1145,543,571,0,1114
14,JALISCO,5,PUERTO VALLARTA,12,ATENGUILLO,156,434,441,0,875,420,434,0,854
14,JALISCO,5,PUERTO VALLARTA,12,ATENGUILLO,158,93,106,0,199,92,106,0,198
14,JALISCO,5,PUERTO VALLARTA,12,ATENGUILLO,159,787,802,0,1589,763,775,0,1538
14,JALISCO,5,PUERTO VALLARTA,12,ATENGUILLO,160,125,127,0,252,121,123,0,244
14,JALISCO,5,PUERTO VALLARTA,20,CABO CORRIENTES,296,856,753,0,1609,849,744,0,1593
14,JALISCO,5,PUERTO VALLARTA,20,CABO CORRIENTES,297,1502,1560,0,3062,1478,1530,0,3008
14,JALISCO,5,PUERTO VALLARTA,20,CABO CORRIENTES,298,594,527,0,1121,590,523,0,1113
14,JALISCO,5,PUERTO VALLARTA,20,CABO CORRIENTES,299,558,534,0,1092,550,527,0,1077
14,JALISCO,5,PUERTO VALLARTA,20,CABO CORRIENTES,300,990,867,0,1857,977,856,0,1833
14,JALISCO,5,PUERTO VALLARTA,20,CABO CORRIENTES,301,375,300,0,675,372,299,0,671
14,JALISCO,5,PUERTO VALLARTA,29,CUAUTLA,441,593,636,0,1229,583,618,0,1201
14,JALISCO,5,PUERTO VALLARTA,29,CUAUTLA,442,369,361,0,730,357,346,0,703
14,JALISCO,5,PUERTO VALLARTA,29,CUAUTLA,443,141,123,0,264,137,120,0,257
14,JALISCO,5,PUERTO VALLARTA,29,CUAUTLA,444,150,167,0,317,146,164,0,310
14,JALISCO,5,PUERTO VALLARTA,40,GUACHINANGO,561,673,663,0,1336,650,636,0,1286
14,JALISCO,5,PUERTO VALLARTA,40,GUACHINANGO,562,440,435,0,875,434,426,0,860
14,JALISCO,5,PUERTO VALLARTA,40,GUACHINANGO,563,276,288,0,564,273,283,0,556
14,JALISCO,5,PUERTO VALLARTA,40,GUACHINANGO,564,76,47,0,123,76,47,0,123
14,JALISCO,5,PUERTO VALLARTA,40,GUACHINANGO,565,250,194,0,444,239,193,0,432
14,JALISCO,5,PUERTO VALLARTA,40,GUACHINANGO,566,57,47,0,104,57,45,0,102
14,JALISCO,5,PUERTO VALLARTA,40,GUACHINANGO,567,143,123,0,266,143,117,0,260
14,JALISCO,5,PUERTO VALLARTA,40,GUACHINANGO,569,148,145,0,293,147,143,0,290
14,JALISCO,5,PUERTO VALLARTA,60,MASCOTA,1802,1084,1208,0,2292,1067,1190,0,2257
14,JALISCO,5,PUERTO VALLARTA,60,MASCOTA,1803,681,677,0,1358,667,671,0,1338
14,JALISCO,5,PUERTO VALLARTA,60,MASCOTA,1804,433,460,0,893,427,457,0,884
14,JALISCO,5,PUERTO VALLARTA,60,MASCOTA,1805,934,964,0,1898,920,951,0,1871
14,JALISCO,5,PUERTO VALLARTA,60,MASCOTA,1806,871,964,0,1835,863,953,0,1816
14,JALISCO,5,PUERTO VALLARTA,60,MASCOTA,1807,183,140,0,323,181,138,0,319
14,JALISCO,5,PUERTO VALLARTA,60,MASCOTA,1808,288,307,0,595,284,298,0,582
14,JALISCO,5,PUERTO VALLARTA,60,MASCOTA,1809,384,384,0,768,367,371,0,738
14,JALISCO,5,PUERTO VALLARTA,60,MASCOTA,1810,218,215,0,433,213,209,0,422
14,JALISCO,5,PUERTO VALLARTA,60,MASCOTA,1811,73,69,0,142,73,69,0,142
14,JALISCO,5,PUERTO VALLARTA,60,MASCOTA,1812,103,77,0,180,103,77,0,180
14,JALISCO,5,PUERTO VALLARTA,60,MASCOTA,1813,154,152,0,306,150,152,0,302
14,JALISCO,5,PUERTO VALLARTA,60,MASCOTA,1814,381,367,0,748,375,361,0,736
14,JALISCO,5,PUERTO VALLARTA,60,MASCOTA,3676,357,392,0,749,352,386,0,738
14,JALISCO,5,PUERTO VALLARTA,64,MIXTLAN,1840,393,381,0,774,384,372,0,756
14,JALISCO,5,PUERTO VALLARTA,64,MIXTLAN,1841,616,629,0,1245,602,621,0,1223
14,JALISCO,5,PUERTO VALLARTA,64,MIXTLAN,1842,665,645,0,1310,661,637,0,1298
14,JALISCO,5,PUERTO VALLARTA,64,MIXTLAN,1843,160,168,0,328,156,166,0,322
14,JALISCO,5,PUERTO VALLARTA,69,PUERTO VALLARTA,1934,893,924,0,1817,876,911,0,1787
14,JALISCO,5,PUERTO VALLARTA,69,PUERTO VALLARTA,1937,719,839,0,1558,713,836,0,1549
14,JALISCO,5,PUERTO VALLARTA,69,PUERTO VALLARTA,1938,999,1205,0,2204,994,1197,0,2191
14,JALISCO,5,PUERTO VALLARTA,69,PUERTO VALLARTA,1939,532,558,0,1090,525,554,0,1079
14,JALISCO,5,PUERTO VALLARTA,69,PUERTO VALLARTA,1940,251,263,0,514,246,260,0,506
14,JALISCO,5,PUERTO VALLARTA,69,PUERTO VALLARTA,1942,2482,2379,0,4861,2460,2353,0,4813
14,JALISCO,5,PUERTO VALLARTA,69,PUERTO VALLARTA,1943,3655,3906,0,7561,3625,3876,0,7501
14,JALISCO,5,PUERTO VALLARTA,69,PUERTO VALLARTA,1944,954,972,0,1926,941,958,0,1899
14,JALISCO,5,PUERTO VALLARTA,69,PUERTO VALLARTA,1945,1363,1350,0,2713,1346,1335,0,2681
14,JALISCO,5,PUERTO VALLARTA,69,PUERTO VALLARTA,1947,1213,1167,0,2380,1199,1158,0,2357
14,JALISCO,5,PUERTO VALLARTA,69,PUERTO VALLARTA,1949,898,847,0,1745,889,837,0,1726
14,JALISCO,5,PUERTO VALLARTA,69,PUERTO VALLARTA,1950,3257,3351,0,6608,3227,3327,0,6554
14,JALISCO,5,PUERTO VALLARTA,69,PUERTO VALLARTA,1951,1838,1883,0,3721,1822,1868,0,3690
14,JALISCO,5,PUERTO VALLARTA,69,PUERTO VALLARTA,1952,967,928,0,1895,957,919,0,1876
14,JALISCO,5,PUERTO VALLARTA,69,PUERTO VALLARTA,1953,661,665,0,1326,654,660,0,1314
14,JALISCO,5,PUERTO VALLARTA,69,PUERTO VALLARTA,1954,837,854,0,1691,831,846,0,1677
14,JALISCO,5,PUERTO VALLARTA,69,PUERTO VALLARTA,1955,1236,1335,1,2572,1223,1323,1,2547
14,JALISCO,5,PUERTO VALLARTA,69,PUERTO VALLARTA,1956,2735,2760,0,5495,2704,2728,0,5432
14,JALISCO,5,PUERTO VALLARTA,69,PUERTO VALLARTA,1957,1763,2000,0,3763,1753,1979,0,3732
14,JALISCO,5,PUERTO VALLARTA,69,PUERTO VALLARTA,1958,3187,3130,0,6317,3166,3097,0,6263
14,JALISCO,5,PUERTO VALLARTA,69,PUERTO VALLARTA,1959,3415,3594,0,7009,3381,3568,0,6949
14,JALISCO,5,PUERTO VALLARTA,69,PUERTO VALLARTA,1960,1082,1083,0,2165,1067,1073,0,2140
14,JALISCO,5,PUERTO VALLARTA,69,PUERTO VALLARTA,1961,535,492,0,1027,529,486,0,1015
14,JALISCO,5,PUERTO VALLARTA,69,PUERTO VALLARTA,1962,787,747,0,1534,780,741,0,1521
14,JALISCO,5,PUERTO VALLARTA,69,PUERTO VALLARTA,1963,816,773,0,1589,810,764,0,1574
14,JALISCO,5,PUERTO VALLARTA,69,PUERTO VALLARTA,1964,1638,1667,0,3305,1618,1655,0,3273
14,JALISCO,5,PUERTO VALLARTA,69,PUERTO VALLARTA,1965,1057,998,0,2055,1048,985,0,2033
14,JALISCO,5,PUERTO VALLARTA,69,PUERTO VALLARTA,1966,444,432,0,876,438,429,0,867
14,JALISCO,5,PUERTO VALLARTA,69,PUERTO VALLARTA,1967,4387,4329,0,8716,4340,4295,0,8635
14,JALISCO,5,PUERTO VALLARTA,69,PUERTO VALLARTA,1968,1648,1546,0,3194,1627,1538,0,3165
14,JALISCO,5,PUERTO VALLARTA,69,PUERTO VALLARTA,1969,1954,1928,0,3882,1927,1904,0,3831
14,JALISCO,5,PUERTO VALLARTA,69,PUERTO VALLARTA,1970,955,888,0,1843,950,877,0,1827
14,JALISCO,5,PUERTO VALLARTA,69,PUERTO VALLARTA,1971,1147,1105,0,2252,1138,1098,0,2236
14,JALISCO,5,PUERTO VALLARTA,69,PUERTO VALLARTA,1972,972,907,0,1879,962,898,0,1860
14,JALISCO,5,PUERTO VALLARTA,69,PUERTO VALLARTA,1973,1172,1071,0,2243,1157,1060,0,2217
14,JALISCO,5,PUERTO VALLARTA,69,PUERTO VALLARTA,1974,523,472,0,995,516,462,0,978
14,JALISCO,5,PUERTO VALLARTA,69,PUERTO VALLARTA,1975,613,593,0,1206,607,589,0,1196
14,JALISCO,5,PUERTO VALLARTA,69,PUERTO VALLARTA,1976,367,367,0,734,361,364,0,725
14,JALISCO,5,PUERTO VALLARTA,69,PUERTO VALLARTA,1977,559,512,1,1072,552,504,1,1057
14,JALISCO,5,PUERTO VALLARTA,69,PUERTO VALLARTA,1978,677,655,0,1332,668,649,0,1317
14,JALISCO,5,PUERTO VALLARTA,69,PUERTO VALLARTA,1979,352,384,0,736,346,381,0,727
14,JALISCO,5,PUERTO VALLARTA,69,PUERTO VALLARTA,1980,449,393,0,842,447,393,0,840
14,JALISCO,5,PUERTO VALLARTA,69,PUERTO VALLARTA,1981,466,473,0,939,463,472,0,935
14,JALISCO,5,PUERTO VALLARTA,69,PUERTO VALLARTA,1982,396,392,0,788,395,387,0,782
14,JALISCO,5,PUERTO VALLARTA,69,PUERTO VALLARTA,1983,1569,1517,1,3087,1554,1504,1,3059
14,JALISCO,5,PUERTO VALLARTA,69,PUERTO VALLARTA,1984,794,764,0,1558,790,751,0,1541
14,JALISCO,5,PUERTO VALLARTA,69,PUERTO VALLARTA,1985,739,717,0,1456,731,705,0,1436
14,JALISCO,5,PUERTO VALLARTA,69,PUERTO VALLARTA,1986,618,535,0,1153,609,531,0,1140
14,JALISCO,5,PUERTO VALLARTA,69,PUERTO VALLARTA,1987,346,239,0,585,341,238,0,579
14,JALISCO,5,PUERTO VALLARTA,69,PUERTO VALLARTA,1988,1165,1101,0,2266,1158,1090,0,2248
14,JALISCO,5,PUERTO VALLARTA,69,PUERTO VALLARTA,1989,562,499,0,1061,556,496,0,1052
14,JALISCO,5,PUERTO VALLARTA,69,PUERTO VALLARTA,1990,521,390,0,911,516,386,0,902
14,JALISCO,5,PUERTO VALLARTA,69,PUERTO VALLARTA,1991,1565,1582,0,3147,1530,1538,0,3068
14,JALISCO,5,PUERTO VALLARTA,69,PUERTO VALLARTA,1992,484,458,0,942,476,447,0,923
14,JALISCO,5,PUERTO VALLARTA,69,PUERTO VALLARTA,1993,943,992,0,1935,921,982,0,1903
14,JALISCO,5,PUERTO VALLARTA,69,PUERTO VALLARTA,1994,775,733,0,1508,763,727,0,1490
14,JALISCO,5,PUERTO VALLARTA,69,PUERTO VALLARTA,1995,1693,1732,0,3425,1680,1715,0,3395
14,JALISCO,5,PUERTO VALLARTA,69,PUERTO VALLARTA,1996,4332,4499,0,8831,4285,4462,0,8747
14,JALISCO,5,PUERTO VALLARTA,69,PUERTO VALLARTA,1997,2115,2132,0,4247,2097,2115,0,4212
14,JALISCO,5,PUERTO VALLARTA,69,PUERTO VALLARTA,1999,1720,1669,0,3389,1705,1658,0,3363
14,JALISCO,5,PUERTO VALLARTA,69,PUERTO VALLARTA,2000,4095,3940,0,8035,4051,3899,0,7950
14,JALISCO,5,PUERTO VALLARTA,69,PUERTO VALLARTA,2001,730,707,0,1437,721,697,0,1418
14,JALISCO,5,PUERTO VALLARTA,69,PUERTO VALLARTA,2002,776,747,0,1523,770,740,0,1510
14,JALISCO,5,PUERTO VALLARTA,69,PUERTO VALLARTA,3549,967,957,0,1924,958,945,0,1903
14,JALISCO,5,PUERTO VALLARTA,69,PUERTO VALLARTA,3550,945,895,0,1840,931,884,0,1815
14,JALISCO,5,PUERTO VALLARTA,69,PUERTO VALLARTA,3551,1240,1223,0,2463,1222,1212,0,2434
14,JALISCO,5,PUERTO VALLARTA,69,PUERTO VALLARTA,3552,1425,1410,0,2835,1405,1399,0,2804
14,JALISCO,5,PUERTO VALLARTA,69,PUERTO VALLARTA,3553,1073,996,0,2069,1065,991,0,2056
14,JALISCO,5,PUERTO VALLARTA,69,PUERTO VALLARTA,3554,854,841,0,1695,848,834,0,1682
14,JALISCO,5,PUERTO VALLARTA,69,PUERTO VALLARTA,3555,959,982,0,1941,949,978,0,1927
14,JALISCO,5,PUERTO VALLARTA,69,PUERTO VALLARTA,3556,924,881,0,1805,914,874,0,1788
14,JALISCO,5,PUERTO VALLARTA,69,PUERTO VALLARTA,3557,897,905,0,1802,890,895,0,1785
14,JALISCO,5,PUERTO VALLARTA,69,PUERTO VALLARTA,3558,726,697,0,1423,718,692,0,1410
14,JALISCO,5,PUERTO VALLARTA,69,PUERTO VALLARTA,3559,496,526,0,1022,491,521,0,1012
14,JALISCO,5,PUERTO VALLARTA,69,PUERTO VALLARTA,3701,1057,1019,0,2076,1052,1010,0,2062
14,JALISCO,5,PUERTO VALLARTA,69,PUERTO VALLARTA,3702,717,699,0,1416,712,687,0,1399
14,JALISCO,5,PUERTO VALLARTA,69,PUERTO VALLARTA,3703,1524,1479,0,3003,1513,1467,0,2980
14,JALISCO,5,PUERTO VALLARTA,69,PUERTO VALLARTA,3781,246,226,0,472,242,226,0,468
14,JALISCO,5,PUERTO VALLARTA,69,PUERTO VALLARTA,3782,1139,1118,0,2257,1124,1101,0,2225
14,JALISCO,5,PUERTO VALLARTA,69,PUERTO VALLARTA,3783,1134,1155,0,2289,1118,1144,0,2262
14,JALISCO,5,PUERTO VALLARTA,69,PUERTO VALLARTA,3784,1627,1549,0,3176,1608,1533,0,3141
14,JALISCO,5,PUERTO VALLARTA,69,PUERTO VALLARTA,3785,1080,1135,0,2215,1073,1130,0,2203
14,JALISCO,5,PUERTO VALLARTA,69,PUERTO VALLARTA,3786,553,618,0,1171,549,612,0,1161
14,JALISCO,5,PUERTO VALLARTA,69,PUERTO VALLARTA,3787,1009,968,0,1977,1000,958,0,1958
14,JALISCO,5,PUERTO VALLARTA,69,PUERTO VALLARTA,3788,1449,1548,0,2997,1436,1536,0,2972
14,JALISCO,5,PUERTO VALLARTA,69,PUERTO VALLARTA,3789,1418,1416,0,2834,1409,1404,0,2813
14,JALISCO,5,PUERTO VALLARTA,69,PUERTO VALLARTA,3892,974,986,0,1960,965,981,0,1946
14,JALISCO,5,PUERTO VALLARTA,69,PUERTO VALLARTA,3893,1426,1310,0,2736,1415,1298,0,2713
14,JALISCO,5,PUERTO VALLARTA,69,PUERTO VALLARTA,3894,1129,1130,0,2259,1123,1121,0,2244
14,JALISCO,5,PUERTO VALLARTA,69,PUERTO VALLARTA,3895,1018,966,0,1984,1008,955,0,1963
14,JALISCO,5,PUERTO VALLARTA,69,PUERTO VALLARTA,3896,1037,914,0,1951,1023,906,0,1929
14,JALISCO,5,PUERTO VALLARTA,69,PUERTO VALLARTA,3897,983,945,0,1928,971,939,0,1910
14,JALISCO,5,PUERTO VALLARTA,69,PUERTO VALLARTA,3898,1031,987,0,2018,1016,977,0,1993
14,JALISCO,5,PUERTO VALLARTA,69,PUERTO VALLARTA,3899,1043,1010,0,2053,1030,1001,0,2031
14,JALISCO,5,PUERTO VALLARTA,69,PUERTO VALLARTA,3900,1396,1341,0,2737,1379,1321,0,2700
14,JALISCO,5,PUERTO VALLARTA,69,PUERTO VALLARTA,3901,1356,1206,0,2562,1338,1164,0,2502
14,JALISCO,5,PUERTO VALLARTA,69,PUERTO VALLARTA,3902,1106,1143,0,2249,1083,1123,0,2206
14,JALISCO,5,PUERTO VALLARTA,69,PUERTO VALLARTA,3903,1102,1075,0,2177,1092,1064,0,2156
14,JALISCO,5,PUERTO VALLARTA,69,PUERTO VALLARTA,3904,1356,1414,0,2770,1340,1399,0,2739
14,JALISCO,5,PUERTO VALLARTA,69,PUERTO VALLARTA,3905,1345,1322,0,2667,1333,1309,0,2642
14,JALISCO,5,PUERTO VALLARTA,69,PUERTO VALLARTA,3906,1488,1497,0,2985,1472,1483,0,2955
14,JALISCO,5,PUERTO VALLARTA,81,SAN SEBASTIAN DEL OESTE,2150,469,444,0,913,451,434,0,885
14,JALISCO,5,PUERTO VALLARTA,81,SAN SEBASTIAN DEL OESTE,2151,316,273,0,589,312,269,0,581
14,JALISCO,5,PUERTO VALLARTA,81,SAN SEBASTIAN DEL OESTE,2152,94,75,0,169,90,71,0,161
14,JALISCO,5,PUERTO VALLARTA,81,SAN SEBASTIAN DEL OESTE,2153,769,702,0,1471,728,675,0,1403
14,JALISCO,5,PUERTO VALLARTA,81,SAN SEBASTIAN DEL OESTE,2154,287,242,0,529,270,231,0,501
14,JALISCO,5,PUERTO VALLARTA,81,SAN SEBASTIAN DEL OESTE,2155,249,241,0,490,244,233,0,477
14,JALISCO,5,PUERTO VALLARTA,81,SAN SEBASTIAN DEL OESTE,2156,340,289,0,629,328,283,0,611
14,JALISCO,5,PUERTO VALLARTA,85,TALPA DE ALLENDE,2212,1127,1245,0,2372,1111,1231,0,2342
14,JALISCO,5,PUERTO VALLARTA,85,TALPA DE ALLENDE,2213,1323,1447,0,2770,1313,1430,0,2743
14,JALISCO,5,PUERTO VALLARTA,85,TALPA DE ALLENDE,2214,1498,1650,0,3148,1481,1633,0,3114
14,JALISCO,5,PUERTO VALLARTA,85,TALPA DE ALLENDE,2215,362,341,0,703,358,336,0,694
14,JALISCO,5,PUERTO VALLARTA,85,TALPA DE ALLENDE,2216,271,271,0,542,268,270,0,538
14,JALISCO,5,PUERTO VALLARTA,85,TALPA DE ALLENDE,2217,178,165,0,343,178,165,0,343
14,JALISCO,5,PUERTO VALLARTA,85,TALPA DE ALLENDE,2219,90,72,0,162,90,72,0,162
14,JALISCO,5,PUERTO VALLARTA,85,TALPA DE ALLENDE,2220,476,449,0,925,471,446,0,917
14,JALISCO,5,PUERTO VALLARTA,85,TALPA DE ALLENDE,2221,163,125,0,288,160,125,0,285
14,JALISCO,5,PUERTO VALLARTA,85,TALPA DE ALLENDE,2222,257,241,0,498,256,238,0,494
14,JALISCO,5,PUERTO VALLARTA,101,TOMATLAN,2633,717,779,0,1496,712,776,0,1488
14,JALISCO,5,PUERTO VALLARTA,101,TOMATLAN,2634,771,821,0,1592,766,814,0,1580
14,JALISCO,5,PUERTO VALLARTA,101,TOMATLAN,2635,1339,1387,0,2726,1335,1382,0,2717
14,JALISCO,5,PUERTO VALLARTA,101,TOMATLAN,2636,876,877,0,1753,872,872,0,1744
14,JALISCO,5,PUERTO VALLARTA,101,TOMATLAN,2637,617,589,0,1206,616,589,0,1205
14,JALISCO,5,PUERTO VALLARTA,101,TOMATLAN,2638,677,656,0,1333,673,653,0,1326
14,JALISCO,5,PUERTO VALLARTA,101,TOMATLAN,2639,744,679,0,1423,743,677,0,1420
14,JALISCO,5,PUERTO VALLARTA,101,TOMATLAN,2640,843,808,0,1651,838,803,0,1641
14,JALISCO,5,PUERTO VALLARTA,101,TOMATLAN,2641,225,232,0,457,223,231,0,454
14,JALISCO,5,PUERTO VALLARTA,101,TOMATLAN,2642,903,886,0,1789,898,885,0,1783
14,JALISCO,5,PUERTO VALLARTA,101,TOMATLAN,2643,1646,1598,0,3244,1638,1591,0,3229
14,JALISCO,5,PUERTO VALLARTA,101,TOMATLAN,2644,572,587,0,1159,569,584,0,1153
14,JALISCO,5,PUERTO VALLARTA,101,TOMATLAN,2645,111,85,0,196,111,84,0,195
14,JALISCO,5,PUERTO VALLARTA,101,TOMATLAN,2646,530,483,0,1013,530,482,0,1012
14,JALISCO,5,PUERTO VALLARTA,101,TOMATLAN,2647,423,393,0,816,421,388,0,809
14,JALISCO,5,PUERTO VALLARTA,101,TOMATLAN,2648,1015,1063,0,2078,1011,1059,0,2070
14,JALISCO,5,PUERTO VALLARTA,101,TOMATLAN,2649,1207,1171,0,2378,1204,1169,0,2373
14,JALISCO,6,ZAPOPAN,120,ZAPOPAN,3018,5004,5265,0,10269,4966,5213,0,10179
14,JALISCO,6,ZAPOPAN,120,ZAPOPAN,3020,5397,5736,0,11133,5361,5684,0,11045
14,JALISCO,6,ZAPOPAN,120,ZAPOPAN,3021,1733,1765,0,3498,1713,1745,0,3458
14,JALISCO,6,ZAPOPAN,120,ZAPOPAN,3022,2817,2849,0,5666,2787,2818,0,5605
14,JALISCO,6,ZAPOPAN,120,ZAPOPAN,3025,226,208,0,434,225,204,0,429
14,JALISCO,6,ZAPOPAN,120,ZAPOPAN,3027,646,664,0,1310,639,661,0,1300
14,JALISCO,6,ZAPOPAN,120,ZAPOPAN,3028,2228,2481,0,4709,2213,2460,0,4673
14,JALISCO,6,ZAPOPAN,120,ZAPOPAN,3029,4279,4585,0,8864,4202,4524,0,8726
14,JALISCO,6,ZAPOPAN,120,ZAPOPAN,3031,1140,1225,0,2365,1133,1207,0,2340
14,JALISCO,6,ZAPOPAN,120,ZAPOPAN,3034,687,683,0,1370,684,677,0,1361
14,JALISCO,6,ZAPOPAN,120,ZAPOPAN,3035,541,582,0,1123,534,579,0,1113
14,JALISCO,6,ZAPOPAN,120,ZAPOPAN,3036,786,906,0,1692,775,897,0,1672
14,JALISCO,6,ZAPOPAN,120,ZAPOPAN,3037,845,949,0,1794,836,946,0,1782
14,JALISCO,6,ZAPOPAN,120,ZAPOPAN,3038,907,1051,0,1958,895,1041,0,1936
14,JALISCO,6,ZAPOPAN,120,ZAPOPAN,3039,730,836,0,1566,727,830,0,1557
14,JALISCO,6,ZAPOPAN,120,ZAPOPAN,3040,584,701,0,1285,576,698,0,1274
14,JALISCO,6,ZAPOPAN,120,ZAPOPAN,3041,463,486,0,949,458,482,0,940
14,JALISCO,6,ZAPOPAN,120,ZAPOPAN,3042,730,793,0,1523,721,788,0,1509
14,JALISCO,6,ZAPOPAN,120,ZAPOPAN,3043,466,525,0,991,465,524,0,989
14,JALISCO,6,ZAPOPAN,120,ZAPOPAN,3044,274,304,0,578,273,303,0,576
14,JALISCO,6,ZAPOPAN,120,ZAPOPAN,3045,589,680,0,1269,583,675,0,1258
14,JALISCO,6,ZAPOPAN,120,ZAPOPAN,3046,1364,1550,0,2914,1355,1542,0,2897
14,JALISCO,6,ZAPOPAN,120,ZAPOPAN,3047,395,417,0,812,395,416,0,811
14,JALISCO,6,ZAPOPAN,120,ZAPOPAN,3048,1891,2088,0,3979,1872,2073,0,3945
14,JALISCO,6,ZAPOPAN,120,ZAPOPAN,3049,892,914,0,1806,883,907,0,1790
14,JALISCO,6,ZAPOPAN,120,ZAPOPAN,3059,614,741,0,1355,612,735,0,1347
14,JALISCO,6,ZAPOPAN,120,ZAPOPAN,3060,391,426,0,817,388,422,0,810
14,JALISCO,6,ZAPOPAN,120,ZAPOPAN,3061,1097,1121,0,2218,1089,1114,0,2203
14,JALISCO,6,ZAPOPAN,120,ZAPOPAN,3062,687,652,0,1339,682,644,0,1326
14,JALISCO,6,ZAPOPAN,120,ZAPOPAN,3063,663,673,0,1336,656,666,0,1322
14,JALISCO,6,ZAPOPAN,120,ZAPOPAN,3064,855,917,0,1772,844,912,0,1756
14,JALISCO,6,ZAPOPAN,120,ZAPOPAN,3065,1176,1341,0,2517,1163,1321,0,2484
14,JALISCO,6,ZAPOPAN,120,ZAPOPAN,3066,595,670,0,1265,593,665,0,1258
14,JALISCO,6,ZAPOPAN,120,ZAPOPAN,3117,1315,1281,0,2596,1304,1263,0,2567
14,JALISCO,6,ZAPOPAN,120,ZAPOPAN,3118,1954,1988,0,3942,1935,1972,0,3907
14,JALISCO,6,ZAPOPAN,120,ZAPOPAN,3227,891,1000,0,1891,884,993,0,1877
14,JALISCO,6,ZAPOPAN,120,ZAPOPAN,3228,886,881,0,1767,877,875,0,1752
14,JALISCO,6,ZAPOPAN,120,ZAPOPAN,3229,1384,1313,0,2697,1363,1299,0,2662
14,JALISCO,6,ZAPOPAN,120,ZAPOPAN,3230,1643,1586,0,3229,1620,1577,0,3197
14,JALISCO,6,ZAPOPAN,120,ZAPOPAN,3231,3943,3902,0,7845,3899,3867,0,7766
14,JALISCO,6,ZAPOPAN,120,ZAPOPAN,3232,184,147,0,331,183,145,0,328
14,JALISCO,6,ZAPOPAN,120,ZAPOPAN,3233,1987,2201,0,4188,1958,2182,0,4140
14,JALISCO,6,ZAPOPAN,120,ZAPOPAN,3234,2069,2179,0,4248,2050,2163,0,4213
14,JALISCO,6,ZAPOPAN,120,ZAPOPAN,3363,431,441,0,872,427,439,0,866
14,JALISCO,6,ZAPOPAN,120,ZAPOPAN,3364,245,287,0,532,241,287,0,528
14,JALISCO,6,ZAPOPAN,120,ZAPOPAN,3365,426,460,0,886,421,459,0,880
14,JALISCO,6,ZAPOPAN,120,ZAPOPAN,3366,395,434,0,829,390,428,0,818
14,JALISCO,6,ZAPOPAN,120,ZAPOPAN,3367,332,396,0,728,331,393,0,724
14,JALISCO,6,ZAPOPAN,120,ZAPOPAN,3368,385,442,0,827,384,442,0,826
14,JALISCO,6,ZAPOPAN,120,ZAPOPAN,3369,528,528,0,1056,525,524,0,1049
14,JALISCO,6,ZAPOPAN,120,ZAPOPAN,3370,452,507,0,959,451,506,0,957
14,JALISCO,6,ZAPOPAN,120,ZAPOPAN,3371,420,456,0,876,418,455,0,873
14,JALISCO,6,ZAPOPAN,120,ZAPOPAN,3372,556,636,0,1192,552,635,0,1187
14,JALISCO,6,ZAPOPAN,120,ZAPOPAN,3373,538,575,0,1113,536,572,0,1108
14,JALISCO,6,ZAPOPAN,120,ZAPOPAN,3374,557,619,0,1176,555,615,0,1170
14,JALISCO,6,ZAPOPAN,120,ZAPOPAN,3375,451,483,0,934,448,480,0,928
14,JALISCO,6,ZAPOPAN,120,ZAPOPAN,3376,358,367,0,725,349,363,0,712
14,JALISCO,6,ZAPOPAN,120,ZAPOPAN,3377,361,403,0,764,358,396,0,754
14,JALISCO,6,ZAPOPAN,120,ZAPOPAN,3378,468,509,0,977,460,506,0,966
14,JALISCO,6,ZAPOPAN,120,ZAPOPAN,3379,389,427,0,816,382,421,0,803
14,JALISCO,6,ZAPOPAN,120,ZAPOPAN,3380,373,429,0,802,369,423,0,792
14,JALISCO,6,ZAPOPAN,120,ZAPOPAN,3381,339,343,0,682,339,339,0,678
14,JALISCO,6,ZAPOPAN,120,ZAPOPAN,3382,585,621,0,1206,582,614,0,1196
14,JALISCO,6,ZAPOPAN,120,ZAPOPAN,3383,681,741,0,1422,676,737,0,1413
14,JALISCO,6,ZAPOPAN,120,ZAPOPAN,3384,587,612,0,1199,583,604,0,1187
14,JALISCO,6,ZAPOPAN,120,ZAPOPAN,3385,421,392,0,813,417,390,0,807
14,JALISCO,6,ZAPOPAN,120,ZAPOPAN,3386,566,601,0,1167,561,597,0,1158
14,JALISCO,6,ZAPOPAN,120,ZAPOPAN,3387,409,414,0,823,406,408,0,814
14,JALISCO,6,ZAPOPAN,120,ZAPOPAN,3496,269,270,0,539,265,265,0,530
14,JALISCO,6,ZAPOPAN,120,ZAPOPAN,3497,402,460,0,862,399,453,0,852
14,JALISCO,6,ZAPOPAN,120,ZAPOPAN,3498,570,555,0,1125,569,553,0,1122
14,JALISCO,6,ZAPOPAN,120,ZAPOPAN,3499,608,613,0,1221,600,600,0,1200
14,JALISCO,6,ZAPOPAN,120,ZAPOPAN,3500,457,478,0,935,452,469,0,921
14,JALISCO,6,ZAPOPAN,120,ZAPOPAN,3501,402,429,0,831,400,427,0,827
14,JALISCO,6,ZAPOPAN,120,ZAPOPAN,3502,440,446,0,886,437,441,0,878
14,JALISCO,6,ZAPOPAN,120,ZAPOPAN,3503,654,680,0,1334,650,676,0,1326
14,JALISCO,6,ZAPOPAN,120,ZAPOPAN,3504,643,705,0,1348,636,696,0,1332
14,JALISCO,6,ZAPOPAN,120,ZAPOPAN,3505,1073,1059,0,2132,1060,1050,0,2110
14,JALISCO,6,ZAPOPAN,120,ZAPOPAN,3506,321,340,0,661,317,338,0,655
14,JALISCO,6,ZAPOPAN,120,ZAPOPAN,3507,387,388,0,775,378,384,0,762
14,JALISCO,6,ZAPOPAN,120,ZAPOPAN,3508,282,289,0,571,277,285,0,562
14,JALISCO,6,ZAPOPAN,120,ZAPOPAN,3509,355,342,0,697,355,341,0,696
14,JALISCO,6,ZAPOPAN,120,ZAPOPAN,3510,287,297,0,584,285,294,0,579
14,JALISCO,6,ZAPOPAN,120,ZAPOPAN,3511,604,682,0,1286,597,676,0,1273
14,JALISCO,6,ZAPOPAN,120,ZAPOPAN,3512,363,350,0,713,357,347,0,704
14,JALISCO,6,ZAPOPAN,120,ZAPOPAN,3513,334,338,0,672,331,336,0,667
14,JALISCO,6,ZAPOPAN,120,ZAPOPAN,3514,477,479,0,956,470,476,0,946
14,JALISCO,6,ZAPOPAN,120,ZAPOPAN,3515,461,488,0,949,458,484,0,942
14,JALISCO,6,ZAPOPAN,120,ZAPOPAN,3516,224,233,0,457,223,228,0,451
14,JALISCO,6,ZAPOPAN,120,ZAPOPAN,3517,322,309,0,631,318,306,0,624
14,JALISCO,6,ZAPOPAN,120,ZAPOPAN,3518,333,338,0,671,327,335,0,662
14,JALISCO,6,ZAPOPAN,120,ZAPOPAN,3519,519,490,0,1009,516,484,0,1000
14,JALISCO,6,ZAPOPAN,120,ZAPOPAN,3520,271,275,0,546,265,270,0,535
14,JALISCO,6,ZAPOPAN,120,ZAPOPAN,3521,502,498,0,1000,496,492,0,988
14,JALISCO,6,ZAPOPAN,120,ZAPOPAN,3522,256,274,0,530,252,270,0,522
14,JALISCO,6,ZAPOPAN,120,ZAPOPAN,3523,423,429,0,852,419,428,0,847
14,JALISCO,6,ZAPOPAN,120,ZAPOPAN,3524,433,534,0,967,429,533,0,962
14,JALISCO,6,ZAPOPAN,120,ZAPOPAN,3525,271,293,0,564,269,289,0,558
14,JALISCO,6,ZAPOPAN,120,ZAPOPAN,3526,565,621,0,1186,561,616,0,1177
14,JALISCO,6,ZAPOPAN,120,ZAPOPAN,3527,1707,1989,0,3696,1695,1965,0,3660
14,JALISCO,6,ZAPOPAN,120,ZAPOPAN,3560,797,788,0,1585,789,779,0,1568
14,JALISCO,6,ZAPOPAN,120,ZAPOPAN,3561,926,1030,0,1956,922,1014,0,1936
14,JALISCO,6,ZAPOPAN,120,ZAPOPAN,3562,860,1024,0,1884,854,1020,0,1874
14,JALISCO,6,ZAPOPAN,120,ZAPOPAN,3563,1082,1223,0,2305,1071,1216,0,2287
14,JALISCO,6,ZAPOPAN,120,ZAPOPAN,3564,686,786,0,1472,679,777,0,1456
14,JALISCO,6,ZAPOPAN,120,ZAPOPAN,3565,731,828,0,1559,730,820,0,1550
14,JALISCO,6,ZAPOPAN,120,ZAPOPAN,3566,749,845,0,1594,746,837,0,1583
14,JALISCO,6,ZAPOPAN,120,ZAPOPAN,3567,478,556,0,1034,474,555,0,1029
14,JALISCO,6,ZAPOPAN,120,ZAPOPAN,3568,646,734,0,1380,636,727,0,1363
14,JALISCO,6,ZAPOPAN,120,ZAPOPAN,3569,1193,1293,0,2486,1182,1281,0,2463
14,JALISCO,6,ZAPOPAN,120,ZAPOPAN,3570,585,676,0,1261,579,670,0,1249
14,JALISCO,6,ZAPOPAN,120,ZAPOPAN,3571,543,692,0,1235,539,687,0,1226
14,JALISCO,6,ZAPOPAN,120,ZAPOPAN,3572,943,1062,0,2005,925,1041,0,1966
14,JALISCO,6,ZAPOPAN,120,ZAPOPAN,3573,630,678,0,1308,619,669,0,1288
14,JALISCO,6,ZAPOPAN,120,ZAPOPAN,3574,530,531,0,1061,521,527,0,1048
14,JALISCO,6,ZAPOPAN,120,ZAPOPAN,3575,469,517,0,986,466,512,0,978
14,JALISCO,6,ZAPOPAN,120,ZAPOPAN,3576,679,636,0,1315,674,633,0,1307
14,JALISCO,6,ZAPOPAN,120,ZAPOPAN,3622,1941,1934,0,3875,1912,1904,0,3816
14,JALISCO,6,ZAPOPAN,120,ZAPOPAN,3623,278,266,0,544,276,266,0,542
14,JALISCO,6,ZAPOPAN,120,ZAPOPAN,3624,579,573,0,1152,577,565,0,1142
14,JALISCO,6,ZAPOPAN,120,ZAPOPAN,3625,2764,2812,0,5576,2733,2777,0,5510
14,JALISCO,6,ZAPOPAN,120,ZAPOPAN,3626,1471,1492,0,2963,1455,1475,0,2930
14,JALISCO,6,ZAPOPAN,120,ZAPOPAN,3627,1335,1391,0,2726,1315,1379,0,2694
14,JALISCO,6,ZAPOPAN,120,ZAPOPAN,3628,1501,1645,0,3146,1478,1625,0,3103
14,JALISCO,6,ZAPOPAN,120,ZAPOPAN,3629,1366,1381,0,2747,1346,1371,0,2717
14,JALISCO,6,ZAPOPAN,120,ZAPOPAN,3630,2676,2797,0,5473,2622,2752,0,5374
14,JALISCO,6,ZAPOPAN,120,ZAPOPAN,3631,885,912,0,1797,876,904,0,1780
14,JALISCO,6,ZAPOPAN,120,ZAPOPAN,3632,878,911,0,1789,866,896,0,1762
14,JALISCO,6,ZAPOPAN,120,ZAPOPAN,3633,1036,1143,0,2179,1029,1137,0,2166
14,JALISCO,6,ZAPOPAN,120,ZAPOPAN,3790,823,764,0,1587,811,759,0,1570
14,JALISCO,6,ZAPOPAN,120,ZAPOPAN,3791,191,189,0,380,187,187,0,374
14,JALISCO,6,ZAPOPAN,120,ZAPOPAN,3792,1332,1355,0,2687,1316,1335,0,2651
14,JALISCO,6,ZAPOPAN,120,ZAPOPAN,3793,1518,1589,0,3107,1504,1577,0,3081
14,JALISCO,6,ZAPOPAN,120,ZAPOPAN,3794,1705,1772,0,3477,1691,1746,0,3437
14,JALISCO,6,ZAPOPAN,120,ZAPOPAN,3795,1199,1290,0,2489,1189,1271,0,2460
14,JALISCO,6,ZAPOPAN,120,ZAPOPAN,3796,724,736,0,1460,716,723,0,1439
14,JALISCO,6,ZAPOPAN,120,ZAPOPAN,3797,1254,1426,0,2680,1237,1410,0,2647
14,JALISCO,6,ZAPOPAN,120,ZAPOPAN,3798,1353,1427,0,2780,1332,1414,0,2746
14,JALISCO,6,ZAPOPAN,120,ZAPOPAN,3799,1566,1590,0,3156,1548,1573,0,3121
14,JALISCO,6,ZAPOPAN,120,ZAPOPAN,3913,274,331,0,605,272,326,0,598
14,JALISCO,6,ZAPOPAN,120,ZAPOPAN,3914,359,332,0,691,352,330,0,682
14,JALISCO,6,ZAPOPAN,120,ZAPOPAN,3915,1356,1381,0,2737,1342,1369,0,2711
14,JALISCO,6,ZAPOPAN,120,ZAPOPAN,3916,1419,1453,0,2872,1406,1435,0,2841
14,JALISCO,6,ZAPOPAN,120,ZAPOPAN,3917,752,754,0,1506,747,748,0,1495
14,JALISCO,6,ZAPOPAN,120,ZAPOPAN,3918,1290,1248,0,2538,1279,1233,0,2512
14,JALISCO,6,ZAPOPAN,120,ZAPOPAN,3919,710,755,0,1465,706,747,0,1453
14,JALISCO,6,ZAPOPAN,120,ZAPOPAN,3920,341,381,0,722,339,381,0,720
14,JALISCO,6,ZAPOPAN,120,ZAPOPAN,3921,1035,1054,0,2089,1022,1041,0,2063
14,JALISCO,6,ZAPOPAN,120,ZAPOPAN,3922,1239,1401,0,2640,1230,1383,0,2613
14,JALISCO,6,ZAPOPAN,120,ZAPOPAN,3923,1321,1321,0,2642,1307,1315,0,2622
14,JALISCO,6,ZAPOPAN,120,ZAPOPAN,3924,871,885,0,1756,863,876,0,1739
14,JALISCO,6,ZAPOPAN,120,ZAPOPAN,3925,1000,1009,0,2009,994,1006,0,2000
14,JALISCO,6,ZAPOPAN,120,ZAPOPAN,3926,892,898,0,1790,882,890,0,1772
14,JALISCO,6,ZAPOPAN,120,ZAPOPAN,3927,499,554,0,1053,496,547,0,1043
14,JALISCO,6,ZAPOPAN,120,ZAPOPAN,3928,1017,1102,0,2119,1004,1095,0,2099
14,JALISCO,6,ZAPOPAN,120,ZAPOPAN,3929,831,919,0,1750,824,910,0,1734
14,JALISCO,6,ZAPOPAN,120,ZAPOPAN,3930,1408,1562,0,2970,1397,1552,0,2949
14,JALISCO,6,ZAPOPAN,120,ZAPOPAN,3931,1365,1489,0,2854,1357,1478,0,2835
14,JALISCO,6,ZAPOPAN,120,ZAPOPAN,3932,1096,1205,0,2301,1081,1190,0,2271
14,JALISCO,6,ZAPOPAN,120,ZAPOPAN,3933,906,940,0,1846,889,932,0,1821
14,JALISCO,6,ZAPOPAN,120,ZAPOPAN,3934,324,292,0,616,315,287,0,602
14,JALISCO,6,ZAPOPAN,120,ZAPOPAN,3935,657,724,0,1381,648,716,0,1364
14,JALISCO,6,ZAPOPAN,120,ZAPOPAN,3936,425,409,0,834,418,398,0,816
14,JALISCO,6,ZAPOPAN,120,ZAPOPAN,3937,892,789,0,1681,876,779,0,1655
14,JALISCO,6,ZAPOPAN,120,ZAPOPAN,3938,1439,1403,0,2842,1417,1380,0,2797
14,JALISCO,6,ZAPOPAN,120,ZAPOPAN,3939,740,716,0,1456,724,706,0,1430
14,JALISCO,6,ZAPOPAN,120,ZAPOPAN,3940,588,638,0,1226,582,635,0,1217
14,JALISCO,6,ZAPOPAN,120,ZAPOPAN,3941,884,823,0,1707,867,810,0,1677
14,JALISCO,6,ZAPOPAN,120,ZAPOPAN,3942,884,877,0,1761,876,870,0,1746
14,JALISCO,6,ZAPOPAN,120,ZAPOPAN,3943,628,632,0,1260,623,626,0,1249
14,JALISCO,6,ZAPOPAN,120,ZAPOPAN,3944,873,955,0,1828,861,945,0,1806
14,JALISCO,6,ZAPOPAN,120,ZAPOPAN,3945,744,689,0,1433,738,683,0,1421
14,JALISCO,7,TONALA,102,TONALA,2650,2536,2673,0,5209,2518,2654,0,5172
14,JALISCO,7,TONALA,102,TONALA,2651,3397,3512,0,6909,3364,3480,0,6844
14,JALISCO,7,TONALA,102,TONALA,2652,1197,1198,0,2395,1189,1188,0,2377
14,JALISCO,7,TONALA,102,TONALA,2653,731,716,0,1447,723,709,0,1432
14,JALISCO,7,TONALA,102,TONALA,2654,859,920,0,1779,853,911,0,1764
14,JALISCO,7,TONALA,102,TONALA,2655,1141,1250,0,2391,1129,1241,0,2370
14,JALISCO,7,TONALA,102,TONALA,2656,1577,1709,0,3286,1570,1696,0,3266
14,JALISCO,7,TONALA,102,TONALA,2657,1629,1675,0,3304,1610,1663,0,3273
14,JALISCO,7,TONALA,102,TONALA,2658,750,784,0,1534,741,777,0,1518
14,JALISCO,7,TONALA,102,TONALA,2659,882,929,0,1811,874,920,0,1794
14,JALISCO,7,TONALA,102,TONALA,2660,5027,5133,0,10160,4982,5099,0,10081
14,JALISCO,7,TONALA,102,TONALA,2663,2331,2523,0,4854,2310,2512,0,4822
14,JALISCO,7,TONALA,102,TONALA,2664,2059,2130,0,4189,2044,2113,0,4157
14,JALISCO,7,TONALA,102,TONALA,2665,1415,1477,0,2892,1405,1471,0,2876
14,JALISCO,7,TONALA,102,TONALA,2666,1026,1072,1,2099,1020,1062,1,2083
14,JALISCO,7,TONALA,102,TONALA,2667,1043,1077,0,2120,1033,1065,0,2098
14,JALISCO,7,TONALA,102,TONALA,2668,1712,1786,0,3498,1694,1776,0,3470
14,JALISCO,7,TONALA,102,TONALA,2669,818,805,0,1623,810,797,0,1607
14,JALISCO,7,TONALA,102,TONALA,2670,1526,1594,0,3120,1508,1584,0,3092
14,JALISCO,7,TONALA,102,TONALA,2671,1375,1302,0,2677,1366,1299,0,2665
14,JALISCO,7,TONALA,102,TONALA,2672,784,872,0,1656,778,867,0,1645
14,JALISCO,7,TONALA,102,TONALA,2673,807,835,0,1642,801,833,0,1634
14,JALISCO,7,TONALA,102,TONALA,2674,1223,1298,0,2521,1208,1287,0,2495
14,JALISCO,7,TONALA,102,TONALA,2678,1433,1462,0,2895,1422,1446,0,2868
14,JALISCO,7,TONALA,102,TONALA,2679,3127,3254,0,6381,3102,3223,0,6325
14,JALISCO,7,TONALA,102,TONALA,2680,1563,1545,0,3108,1547,1530,0,3077
14,JALISCO,7,TONALA,102,TONALA,2681,1682,1761,0,3443,1669,1747,0,3416
14,JALISCO,7,TONALA,102,TONALA,2682,1877,1893,0,3770,1855,1875,0,3730
14,JALISCO,7,TONALA,102,TONALA,2683,3171,3332,0,6503,3137,3300,0,6437
14,JALISCO,7,TONALA,102,TONALA,2684,4216,4508,0,8724,4180,4475,0,8655
14,JALISCO,7,TONALA,102,TONALA,2685,1444,1429,0,2873,1432,1419,0,2851
14,JALISCO,7,TONALA,102,TONALA,2687,1020,1181,0,2201,1011,1175,0,2186
14,JALISCO,7,TONALA,102,TONALA,2688,436,486,0,922,435,483,0,918
14,JALISCO,7,TONALA,102,TONALA,2689,531,563,0,1094,527,562,0,1089
14,JALISCO,7,TONALA,102,TONALA,2690,610,633,0,1243,608,629,0,1237
14,JALISCO,7,TONALA,102,TONALA,2697,3961,4272,0,8233,3922,4246,0,8168
14,JALISCO,7,TONALA,102,TONALA,2698,807,827,0,1634,801,820,0,1621
14,JALISCO,7,TONALA,102,TONALA,2699,641,679,0,1320,635,677,0,1312
14,JALISCO,7,TONALA,102,TONALA,2700,635,709,0,1344,629,700,0,1329
14,JALISCO,7,TONALA,102,TONALA,2701,1767,1819,0,3586,1750,1802,0,3552
14,JALISCO,7,TONALA,102,TONALA,2702,1748,1722,0,3470,1730,1710,0,3440
14,JALISCO,7,TONALA,102,TONALA,2703,1556,1588,0,3144,1537,1579,0,3116
14,JALISCO,7,TONALA,102,TONALA,2704,901,1038,0,1939,892,1031,0,1923
14,JALISCO,7,TONALA,102,TONALA,2705,610,648,0,1258,600,639,0,1239
14,JALISCO,7,TONALA,102,TONALA,2706,547,615,0,1162,543,611,0,1154
14,JALISCO,7,TONALA,102,TONALA,2707,3674,4007,0,7681,3638,3949,0,7587
14,JALISCO,7,TONALA,102,TONALA,2708,813,904,0,1717,809,898,0,1707
14,JALISCO,7,TONALA,102,TONALA,2709,4415,4862,2,9279,4381,4816,0,9197
14,JALISCO,7,TONALA,102,TONALA,2710,3151,3570,0,6721,3127,3548,0,6675
14,JALISCO,7,TONALA,102,TONALA,2714,989,1083,0,2072,979,1071,0,2050
14,JALISCO,7,TONALA,102,TONALA,2715,711,739,0,1450,705,734,0,1439
14,JALISCO,7,TONALA,102,TONALA,2727,2844,2977,0,5821,2816,2943,0,5759
14,JALISCO,7,TONALA,102,TONALA,3704,1129,1216,0,2345,1110,1204,0,2314
14,JALISCO,7,TONALA,102,TONALA,3705,671,689,0,1360,664,686,0,1350
14,JALISCO,7,TONALA,102,TONALA,3706,1414,1498,0,2912,1398,1488,0,2886
14,JALISCO,7,TONALA,102,TONALA,3707,925,908,0,1833,921,901,0,1822
14,JALISCO,7,TONALA,102,TONALA,3708,710,761,0,1471,706,759,0,1465
14,JALISCO,7,TONALA,102,TONALA,3709,583,581,0,1164,578,581,0,1159
14,JALISCO,7,TONALA,102,TONALA,3710,1275,1283,0,2558,1271,1275,0,2546
14,JALISCO,7,TONALA,102,TONALA,3711,1363,1388,0,2751,1345,1369,0,2714
14,JALISCO,7,TONALA,102,TONALA,3712,1223,1253,0,2476,1212,1242,0,2454
14,JALISCO,7,TONALA,102,TONALA,3713,1085,1161,1,2247,1074,1158,1,2233
14,JALISCO,7,TONALA,102,TONALA,3714,703,642,0,1345,698,638,0,1336
14,JALISCO,7,TONALA,102,TONALA,3715,520,517,0,1037,516,510,0,1026
14,JALISCO,7,TONALA,102,TONALA,3800,1191,1124,0,2315,1178,1117,0,2295
14,JALISCO,7,TONALA,102,TONALA,3801,1228,1368,0,2596,1220,1352,0,2572
14,JALISCO,7,TONALA,102,TONALA,3802,1589,1653,0,3242,1570,1645,0,3215
14,JALISCO,7,TONALA,102,TONALA,3803,987,1023,0,2010,976,1020,0,1996
14,JALISCO,7,TONALA,102,TONALA,3804,1105,1175,0,2280,1091,1155,0,2246
14,JALISCO,7,TONALA,102,TONALA,3805,745,811,0,1556,737,804,0,1541
14,JALISCO,7,TONALA,102,TONALA,3806,1398,1487,0,2885,1383,1468,0,2851
14,JALISCO,7,TONALA,102,TONALA,3861,460,473,0,933,451,468,0,919
14,JALISCO,7,TONALA,102,TONALA,3862,712,708,0,1420,705,701,0,1406
14,JALISCO,7,TONALA,102,TONALA,3863,655,672,0,1327,652,661,0,1313
14,JALISCO,7,TONALA,102,TONALA,3864,1265,1264,1,2530,1246,1246,1,2493
14,JALISCO,7,TONALA,102,TONALA,3865,547,643,0,1190,539,632,0,1171
14,JALISCO,7,TONALA,102,TONALA,3866,668,750,0,1418,662,745,0,1407
14,JALISCO,7,TONALA,102,TONALA,3867,1174,1133,0,2307,1163,1122,0,2285
14,JALISCO,7,TONALA,102,TONALA,3868,664,668,0,1332,656,659,0,1315
14,JALISCO,7,TONALA,102,TONALA,3869,646,686,0,1332,640,679,0,1319
14,JALISCO,7,TONALA,102,TONALA,3870,707,745,0,1452,692,740,0,1432
14,JALISCO,7,TONALA,102,TONALA,3871,1180,1170,0,2350,1172,1159,0,2331
14,JALISCO,7,TONALA,102,TONALA,3872,967,1019,0,1986,958,1014,0,1972
14,JALISCO,7,TONALA,102,TONALA,3873,1322,1402,0,2724,1306,1393,0,2699
14,JALISCO,7,TONALA,102,TONALA,3946,1163,1232,0,2395,1155,1221,0,2376
14,JALISCO,7,TONALA,102,TONALA,3947,1159,1173,0,2332,1150,1166,0,2316
14,JALISCO,7,TONALA,102,TONALA,3948,1250,1288,0,2538,1244,1285,0,2529
14,JALISCO,7,TONALA,102,TONALA,3949,1051,1139,0,2190,1044,1133,0,2177
14,JALISCO,7,TONALA,102,TONALA,3950,972,1002,0,1974,966,989,0,1955
14,JALISCO,7,TONALA,102,TONALA,3951,567,585,0,1152,563,582,0,1145
14,JALISCO,7,TONALA,102,TONALA,3952,479,491,0,970,477,487,0,964
14,JALISCO,7,TONALA,102,TONALA,3953,921,955,0,1876,908,947,0,1855
14,JALISCO,7,TONALA,102,TONALA,3954,514,488,0,1002,510,484,0,994
14,JALISCO,7,TONALA,102,TONALA,3955,1011,1092,0,2103,997,1089,0,2086
14,JALISCO,7,TONALA,102,TONALA,3956,538,570,0,1108,536,565,0,1101
14,JALISCO,7,TONALA,102,TONALA,3957,933,1038,0,1971,926,1030,0,1956
14,JALISCO,7,TONALA,102,TONALA,3958,988,989,0,1977,973,977,0,1950
14,JALISCO,7,TONALA,102,TONALA,3959,1009,1058,0,2067,997,1051,0,2048
14,JALISCO,7,TONALA,102,TONALA,3960,1203,1228,0,2431,1193,1218,0,2411
14,JALISCO,7,TONALA,102,TONALA,3961,1049,1139,0,2188,1034,1126,0,2160
14,JALISCO,7,TONALA,102,TONALA,3962,1381,1403,0,2784,1369,1391,0,2760
14,JALISCO,7,TONALA,102,TONALA,3963,1156,1262,0,2418,1140,1249,0,2389
14,JALISCO,7,TONALA,102,TONALA,3964,664,716,0,1380,656,711,0,1367
14,JALISCO,7,TONALA,102,TONALA,3965,1080,1191,0,2271,1074,1177,0,2251
14,JALISCO,8,GUADALAJARA,41,GUADALAJARA,570,236,257,0,493,234,254,0,488
14,JALISCO,8,GUADALAJARA,41,GUADALAJARA,571,257,305,0,562,252,304,0,556
14,JALISCO,8,GUADALAJARA,41,GUADALAJARA,572,331,375,0,706,328,372,0,700
14,JALISCO,8,GUADALAJARA,41,GUADALAJARA,573,303,352,0,655,301,350,0,651
14,JALISCO,8,GUADALAJARA,41,GUADALAJARA,574,259,316,0,575,256,314,0,570
14,JALISCO,8,GUADALAJARA,41,GUADALAJARA,575,299,341,0,640,294,339,0,633
14,JALISCO,8,GUADALAJARA,41,GUADALAJARA,576,300,313,0,613,296,312,0,608
14,JALISCO,8,GUADALAJARA,41,GUADALAJARA,577,299,356,0,655,297,355,0,652
14,JALISCO,8,GUADALAJARA,41,GUADALAJARA,578,483,532,0,1015,479,529,0,1008
14,JALISCO,8,GUADALAJARA,41,GUADALAJARA,579,361,409,0,770,360,407,0,767
14,JALISCO,8,GUADALAJARA,41,GUADALAJARA,580,232,219,0,451,231,218,0,449
14,JALISCO,8,GUADALAJARA,41,GUADALAJARA,581,353,378,0,731,351,375,0,726
14,JALISCO,8,GUADALAJARA,41,GUADALAJARA,582,487,486,0,973,487,485,0,972
14,JALISCO,8,GUADALAJARA,41,GUADALAJARA,583,309,307,0,616,309,303,0,612
14,JALISCO,8,GUADALAJARA,41,GUADALAJARA,584,353,390,0,743,348,386,0,734
14,JALISCO,8,GUADALAJARA,41,GUADALAJARA,585,319,360,0,679,317,357,0,674
14,JALISCO,8,GUADALAJARA,41,GUADALAJARA,586,546,624,0,1170,544,619,0,1163
14,JALISCO,8,GUADALAJARA,41,GUADALAJARA,587,626,655,0,1281,623,644,0,1267
14,JALISCO,8,GUADALAJARA,41,GUADALAJARA,588,357,385,0,742,354,383,0,737
14,JALISCO,8,GUADALAJARA,41,GUADALAJARA,589,358,357,0,715,356,351,0,707
14,JALISCO,8,GUADALAJARA,41,GUADALAJARA,590,375,434,0,809,373,433,0,806
14,JALISCO,8,GUADALAJARA,41,GUADALAJARA,591,404,495,0,899,400,491,0,891
14,JALISCO,8,GUADALAJARA,41,GUADALAJARA,592,426,470,0,896,421,467,0,888
14,JALISCO,8,GUADALAJARA,41,GUADALAJARA,593,678,777,0,1455,670,767,0,1437
14,JALISCO,8,GUADALAJARA,41,GUADALAJARA,594,315,371,0,686,314,368,0,682
14,JALISCO,8,GUADALAJARA,41,GUADALAJARA,595,297,330,0,627,294,329,0,623
14,JALISCO,8,GUADALAJARA,41,GUADALAJARA,596,285,335,0,620,281,332,0,613
14,JALISCO,8,GUADALAJARA,41,GUADALAJARA,597,359,371,0,730,352,369,0,721
14,JALISCO,8,GUADALAJARA,41,GUADALAJARA,598,252,255,0,507,248,253,0,501
14,JALISCO,8,GUADALAJARA,41,GUADALAJARA,599,413,496,0,909,410,492,0,902
14,JALISCO,8,GUADALAJARA,41,GUADALAJARA,600,563,611,0,1174,558,607,0,1165
14,JALISCO,8,GUADALAJARA,41,GUADALAJARA,601,510,521,0,1031,507,518,0,1025
14,JALISCO,8,GUADALAJARA,41,GUADALAJARA,602,520,559,0,1079,516,556,0,1072
14,JALISCO,8,GUADALAJARA,41,GUADALAJARA,603,411,391,0,802,409,388,0,797
14,JALISCO,8,GUADALAJARA,41,GUADALAJARA,604,308,307,0,615,304,306,0,610
14,JALISCO,8,GUADALAJARA,41,GUADALAJARA,605,392,382,0,774,388,381,0,769
14,JALISCO,8,GUADALAJARA,41,GUADALAJARA,606,307,375,0,682,302,373,0,675
14,JALISCO,8,GUADALAJARA,41,GUADALAJARA,607,318,407,0,725,313,404,0,717
14,JALISCO,8,GUADALAJARA,41,GUADALAJARA,608,338,353,0,691,336,350,0,686
14,JALISCO,8,GUADALAJARA,41,GUADALAJARA,609,499,490,0,989,492,487,0,979
14,JALISCO,8,GUADALAJARA,41,GUADALAJARA,610,329,339,0,668,325,336,0,661
14,JALISCO,8,GUADALAJARA,41,GUADALAJARA,611,426,464,0,890,422,461,0,883
14,JALISCO,8,GUADALAJARA,41,GUADALAJARA,612,438,396,0,834,434,393,0,827
14,JALISCO,8,GUADALAJARA,41,GUADALAJARA,613,434,420,0,854,431,417,0,848
14,JALISCO,8,GUADALAJARA,41,GUADALAJARA,614,546,531,0,1077,542,528,0,1070
14,JALISCO,8,GUADALAJARA,41,GUADALAJARA,615,250,267,0,517,249,266,0,515
14,JALISCO,8,GUADALAJARA,41,GUADALAJARA,616,514,603,0,1117,508,595,0,1103
14,JALISCO,8,GUADALAJARA,41,GUADALAJARA,617,374,383,0,757,371,382,0,753
14,JALISCO,8,GUADALAJARA,41,GUADALAJARA,618,379,327,0,706,376,323,0,699
14,JALISCO,8,GUADALAJARA,41,GUADALAJARA,619,262,205,0,467,259,202,0,461
14,JALISCO,8,GUADALAJARA,41,GUADALAJARA,620,374,290,0,664,367,287,0,654
14,JALISCO,8,GUADALAJARA,41,GUADALAJARA,621,487,368,1,856,483,365,1,849
14,JALISCO,8,GUADALAJARA,41,GUADALAJARA,622,478,397,0,875,476,395,0,871
14,JALISCO,8,GUADALAJARA,41,GUADALAJARA,623,337,357,0,694,336,353,0,689
14,JALISCO,8,GUADALAJARA,41,GUADALAJARA,624,409,384,0,793,407,377,0,784
14,JALISCO,8,GUADALAJARA,41,GUADALAJARA,625,282,284,0,566,279,282,0,561
14,JALISCO,8,GUADALAJARA,41,GUADALAJARA,626,522,467,0,989,514,462,0,976
14,JALISCO,8,GUADALAJARA,41,GUADALAJARA,627,437,410,0,847,436,407,0,843
14,JALISCO,8,GUADALAJARA,41,GUADALAJARA,628,383,362,0,745,381,359,0,740
14,JALISCO,8,GUADALAJARA,41,GUADALAJARA,629,274,325,0,599,273,321,0,594
14,JALISCO,8,GUADALAJARA,41,GUADALAJARA,630,578,558,0,1136,575,551,0,1126
14,JALISCO,8,GUADALAJARA,41,GUADALAJARA,631,582,690,0,1272,574,685,0,1259
14,JALISCO,8,GUADALAJARA,41,GUADALAJARA,632,298,334,0,632,294,330,0,624
14,JALISCO,8,GUADALAJARA,41,GUADALAJARA,757,376,419,0,795,373,417,0,790
14,JALISCO,8,GUADALAJARA,41,GUADALAJARA,758,486,505,0,991,485,501,0,986
14,JALISCO,8,GUADALAJARA,41,GUADALAJARA,759,628,702,0,1330,619,697,0,1316
14,JALISCO,8,GUADALAJARA,41,GUADALAJARA,760,542,541,0,1083,536,533,0,1069
14,JALISCO,8,GUADALAJARA,41,GUADALAJARA,761,388,461,0,849,386,457,0,843
14,JALISCO,8,GUADALAJARA,41,GUADALAJARA,762,487,587,0,1074,479,583,0,1062
14,JALISCO,8,GUADALAJARA,41,GUADALAJARA,763,288,384,1,673,284,381,1,666
14,JALISCO,8,GUADALAJARA,41,GUADALAJARA,764,297,296,0,593,296,292,0,588
14,JALISCO,8,GUADALAJARA,41,GUADALAJARA,765,281,326,0,607,280,322,0,602
14,JALISCO,8,GUADALAJARA,41,GUADALAJARA,766,553,665,0,1218,548,661,0,1209
14,JALISCO,8,GUADALAJARA,41,GUADALAJARA,767,327,363,0,690,327,358,0,685
14,JALISCO,8,GUADALAJARA,41,GUADALAJARA,768,289,356,0,645,287,355,0,642
14,JALISCO,8,GUADALAJARA,41,GUADALAJARA,769,510,669,0,1179,508,661,0,1169
14,JALISCO,8,GUADALAJARA,41,GUADALAJARA,770,397,454,0,851,393,452,0,845
14,JALISCO,8,GUADALAJARA,41,GUADALAJARA,771,655,710,0,1365,648,706,0,1354
14,JALISCO,8,GUADALAJARA,41,GUADALAJARA,772,373,433,0,806,366,431,0,797
14,JALISCO,8,GUADALAJARA,41,GUADALAJARA,773,526,544,0,1070,520,537,0,1057
14,JALISCO,8,GUADALAJARA,41,GUADALAJARA,774,436,468,0,904,433,466,0,899
14,JALISCO,8,GUADALAJARA,41,GUADALAJARA,775,339,374,0,713,338,369,0,707
14,JALISCO,8,GUADALAJARA,41,GUADALAJARA,776,411,483,0,894,409,481,0,890
14,JALISCO,8,GUADALAJARA,41,GUADALAJARA,777,551,694,0,1245,547,689,0,1236
14,JALISCO,8,GUADALAJARA,41,GUADALAJARA,778,532,602,0,1134,529,598,0,1127
14,JALISCO,8,GUADALAJARA,41,GUADALAJARA,779,628,671,0,1299,624,665,0,1289
14,JALISCO,8,GUADALAJARA,41,GUADALAJARA,780,515,559,0,1074,514,554,0,1068
14,JALISCO,8,GUADALAJARA,41,GUADALAJARA,781,400,444,0,844,399,443,0,842
14,JALISCO,8,GUADALAJARA,41,GUADALAJARA,782,449,437,0,886,444,430,0,874
14,JALISCO,8,GUADALAJARA,41,GUADALAJARA,783,494,558,1,1053,490,554,1,1045
14,JALISCO,8,GUADALAJARA,41,GUADALAJARA,784,724,780,0,1504,721,777,0,1498
14,JALISCO,8,GUADALAJARA,41,GUADALAJARA,785,373,393,0,766,369,388,0,757
14,JALISCO,8,GUADALAJARA,41,GUADALAJARA,786,306,345,0,651,303,342,0,645
14,JALISCO,8,GUADALAJARA,41,GUADALAJARA,787,506,542,0,1048,496,541,0,1037
14,JALISCO,8,GUADALAJARA,41,GUADALAJARA,788,622,709,0,1331,618,702,0,1320
14,JALISCO,8,GUADALAJARA,41,GUADALAJARA,789,540,669,0,1209,537,665,0,1202
14,JALISCO,8,GUADALAJARA,41,GUADALAJARA,790,646,710,0,1356,643,702,0,1345
14,JALISCO,8,GUADALAJARA,41,GUADALAJARA,791,1023,1074,0,2097,1010,1068,0,2078
14,JALISCO,8,GUADALAJARA,41,GUADALAJARA,792,627,655,0,1282,620,653,0,1273
14,JALISCO,8,GUADALAJARA,41,GUADALAJARA,793,660,730,0,1390,653,720,0,1373
14,JALISCO,8,GUADALAJARA,41,GUADALAJARA,794,723,772,0,1495,718,766,0,1484
14,JALISCO,8,GUADALAJARA,41,GUADALAJARA,795,454,487,0,941,446,481,0,927
14,JALISCO,8,GUADALAJARA,41,GUADALAJARA,796,425,465,0,890,418,460,0,878
14,JALISCO,8,GUADALAJARA,41,GUADALAJARA,797,645,674,0,1319,637,669,0,1306
14,JALISCO,8,GUADALAJARA,41,GUADALAJARA,798,654,701,0,1355,647,695,0,1342
14,JALISCO,8,GUADALAJARA,41,GUADALAJARA,799,899,1047,0,1946,890,1031,0,1921
14,JALISCO,8,GUADALAJARA,41,GUADALAJARA,800,409,428,0,837,403,421,0,824
14,JALISCO,8,GUADALAJARA,41,GUADALAJARA,801,581,525,0,1106,576,521,0,1097
14,JALISCO,8,GUADALAJARA,41,GUADALAJARA,802,607,642,0,1249,606,635,0,1241
14,JALISCO,8,GUADALAJARA,41,GUADALAJARA,803,638,710,0,1348,635,705,0,1340
14,JALISCO,8,GUADALAJARA,41,GUADALAJARA,804,536,667,0,1203,532,656,0,1188
14,JALISCO,8,GUADALAJARA,41,GUADALAJARA,805,644,769,0,1413,641,763,0,1404
14,JALISCO,8,GUADALAJARA,41,GUADALAJARA,806,623,646,0,1269,619,638,0,1257
14,JALISCO,8,GUADALAJARA,41,GUADALAJARA,807,922,1075,0,1997,920,1067,0,1987
14,JALISCO,8,GUADALAJARA,41,GUADALAJARA,808,791,914,0,1705,788,909,0,1697
14,JALISCO,8,GUADALAJARA,41,GUADALAJARA,809,739,855,0,1594,733,848,0,1581
14,JALISCO,8,GUADALAJARA,41,GUADALAJARA,810,820,901,0,1721,814,892,0,1706
14,JALISCO,8,GUADALAJARA,41,GUADALAJARA,811,564,619,0,1183,559,609,0,1168
14,JALISCO,8,GUADALAJARA,41,GUADALAJARA,812,529,566,0,1095,522,562,0,1084
14,JALISCO,8,GUADALAJARA,41,GUADALAJARA,813,736,833,0,1569,728,825,0,1553
14,JALISCO,8,GUADALAJARA,41,GUADALAJARA,814,500,589,0,1089,492,585,0,1077
14,JALISCO,8,GUADALAJARA,41,GUADALAJARA,815,425,487,0,912,422,483,0,905
14,JALISCO,8,GUADALAJARA,41,GUADALAJARA,816,667,710,0,1377,659,704,0,1363
14,JALISCO,8,GUADALAJARA,41,GUADALAJARA,817,460,505,0,965,454,496,0,950
14,JALISCO,8,GUADALAJARA,41,GUADALAJARA,818,405,422,0,827,403,419,0,822
14,JALISCO,8,GUADALAJARA,41,GUADALAJARA,819,463,540,0,1003,457,535,0,992
14,JALISCO,8,GUADALAJARA,41,GUADALAJARA,820,366,438,0,804,365,434,0,799
14,JALISCO,8,GUADALAJARA,41,GUADALAJARA,821,692,829,0,1521,689,822,0,1511
14,JALISCO,8,GUADALAJARA,41,GUADALAJARA,822,474,567,0,1041,466,559,0,1025
14,JALISCO,8,GUADALAJARA,41,GUADALAJARA,823,377,430,0,807,372,427,0,799
14,JALISCO,8,GUADALAJARA,41,GUADALAJARA,824,615,697,0,1312,612,695,0,1307
14,JALISCO,8,GUADALAJARA,41,GUADALAJARA,825,652,725,0,1377,645,717,0,1362
14,JALISCO,8,GUADALAJARA,41,GUADALAJARA,826,731,814,0,1545,724,806,0,1530
14,JALISCO,8,GUADALAJARA,41,GUADALAJARA,827,821,909,0,1730,818,902,0,1720
14,JALISCO,8,GUADALAJARA,41,GUADALAJARA,828,866,1040,0,1906,860,1029,0,1889
14,JALISCO,8,GUADALAJARA,41,GUADALAJARA,829,916,955,0,1871,905,946,0,1851
14,JALISCO,8,GUADALAJARA,41,GUADALAJARA,830,794,955,0,1749,784,953,0,1737
14,JALISCO,8,GUADALAJARA,41,GUADALAJARA,831,797,891,0,1688,789,882,0,1671
14,JALISCO,8,GUADALAJARA,41,GUADALAJARA,832,849,988,0,1837,845,980,0,1825
14,JALISCO,8,GUADALAJARA,41,GUADALAJARA,833,749,827,0,1576,741,823,0,1564
14,JALISCO,8,GUADALAJARA,41,GUADALAJARA,834,680,827,0,1507,674,819,0,1493
14,JALISCO,8,GUADALAJARA,41,GUADALAJARA,835,815,881,0,1696,807,876,0,1683
14,JALISCO,8,GUADALAJARA,41,GUADALAJARA,836,567,643,0,1210,562,638,0,1200
14,JALISCO,8,GUADALAJARA,41,GUADALAJARA,837,634,793,0,1427,629,788,0,1417
14,JALISCO,8,GUADALAJARA,41,GUADALAJARA,838,793,921,0,1714,787,916,0,1703
14,JALISCO,8,GUADALAJARA,41,GUADALAJARA,839,723,768,0,1491,717,764,0,1481
14,JALISCO,8,GUADALAJARA,41,GUADALAJARA,840,651,759,0,1410,644,752,0,1396
14,JALISCO,8,GUADALAJARA,41,GUADALAJARA,841,614,671,0,1285,608,664,0,1272
14,JALISCO,8,GUADALAJARA,41,GUADALAJARA,842,768,814,0,1582,762,806,0,1568
14,JALISCO,8,GUADALAJARA,41,GUADALAJARA,843,569,681,0,1250,564,673,0,1237
14,JALISCO,8,GUADALAJARA,41,GUADALAJARA,844,819,867,0,1686,812,859,0,1671
14,JALISCO,8,GUADALAJARA,41,GUADALAJARA,845,708,737,0,1445,704,728,0,1432
14,JALISCO,8,GUADALAJARA,41,GUADALAJARA,846,573,616,0,1189,567,608,0,1175
14,JALISCO,8,GUADALAJARA,41,GUADALAJARA,847,617,604,0,1221,607,600,0,1207
14,JALISCO,8,GUADALAJARA,41,GUADALAJARA,848,527,602,0,1129,519,596,0,1115
14,JALISCO,8,GUADALAJARA,41,GUADALAJARA,849,724,740,0,1464,714,736,0,1450
14,JALISCO,8,GUADALAJARA,41,GUADALAJARA,850,500,523,0,1023,495,516,0,1011
14,JALISCO,8,GUADALAJARA,41,GUADALAJARA,851,870,947,0,1817,868,946,0,1814
14,JALISCO,8,GUADALAJARA,41,GUADALAJARA,852,903,952,0,1855,891,944,0,1835
14,JALISCO,8,GUADALAJARA,41,GUADALAJARA,853,875,1033,0,1908,869,1021,0,1890
14,JALISCO,8,GUADALAJARA,41,GUADALAJARA,854,1079,1089,0,2168,1066,1077,0,2143
14,JALISCO,8,GUADALAJARA,41,GUADALAJARA,855,975,1031,0,2006,964,1021,0,1985
14,JALISCO,8,GUADALAJARA,41,GUADALAJARA,856,1169,1183,0,2352,1159,1174,0,2333
14,JALISCO,8,GUADALAJARA,41,GUADALAJARA,888,883,1014,0,1897,880,1005,0,1885
14,JALISCO,8,GUADALAJARA,41,GUADALAJARA,889,518,598,0,1116,509,594,0,1103
14,JALISCO,8,GUADALAJARA,41,GUADALAJARA,967,446,551,0,997,445,547,0,992
14,JALISCO,8,GUADALAJARA,41,GUADALAJARA,968,420,497,1,918,415,495,1,911
14,JALISCO,8,GUADALAJARA,41,GUADALAJARA,969,301,319,0,620,301,314,0,615
14,JALISCO,8,GUADALAJARA,41,GUADALAJARA,970,270,305,0,575,270,302,0,572
14,JALISCO,8,GUADALAJARA,41,GUADALAJARA,971,300,315,0,615,294,309,0,603
14,JALISCO,8,GUADALAJARA,41,GUADALAJARA,972,334,312,0,646,331,308,0,639
14,JALISCO,8,GUADALAJARA,41,GUADALAJARA,973,398,436,0,834,392,434,0,826
14,JALISCO,8,GUADALAJARA,41,GUADALAJARA,974,297,361,0,658,296,360,0,656
14,JALISCO,8,GUADALAJARA,41,GUADALAJARA,977,346,322,0,668,344,320,0,664
14,JALISCO,8,GUADALAJARA,41,GUADALAJARA,978,451,427,0,878,450,425,0,875
14,JALISCO,8,GUADALAJARA,41,GUADALAJARA,979,320,278,0,598,314,278,0,592
14,JALISCO,8,GUADALAJARA,41,GUADALAJARA,980,382,424,0,806,375,422,0,797
14,JALISCO,8,GUADALAJARA,41,GUADALAJARA,981,426,413,0,839,422,410,0,832
14,JALISCO,8,GUADALAJARA,41,GUADALAJARA,982,692,745,0,1437,686,742,0,1428
14,JALISCO,8,GUADALAJARA,41,GUADALAJARA,983,231,232,0,463,230,231,0,461
14,JALISCO,8,GUADALAJARA,41,GUADALAJARA,984,451,462,0,913,448,456,0,904
14,JALISCO,8,GUADALAJARA,41,GUADALAJARA,985,231,254,0,485,227,251,0,478
14,JALISCO,8,GUADALAJARA,41,GUADALAJARA,986,326,398,0,724,325,393,0,718
14,JALISCO,8,GUADALAJARA,41,GUADALAJARA,987,365,425,0,790,362,420,0,782
14,JALISCO,8,GUADALAJARA,41,GUADALAJARA,988,1031,950,0,1981,1017,941,0,1958
14,JALISCO,8,GUADALAJARA,41,GUADALAJARA,989,473,527,0,1000,472,518,0,990
14,JALISCO,8,GUADALAJARA,41,GUADALAJARA,990,783,836,0,1619,776,831,0,1607
14,JALISCO,8,GUADALAJARA,41,GUADALAJARA,991,405,391,0,796,401,387,0,788
14,JALISCO,8,GUADALAJARA,41,GUADALAJARA,992,337,366,0,703,334,363,0,697
14,JALISCO,8,GUADALAJARA,41,GUADALAJARA,993,428,469,0,897,424,466,0,890
14,JALISCO,8,GUADALAJARA,41,GUADALAJARA,994,673,718,0,1391,671,710,0,1381
14,JALISCO,8,GUADALAJARA,41,GUADALAJARA,995,483,465,0,948,475,462,0,937
14,JALISCO,8,GUADALAJARA,41,GUADALAJARA,996,883,1007,0,1890,871,1002,0,1873
14,JALISCO,8,GUADALAJARA,41,GUADALAJARA,997,291,351,0,642,286,350,0,636
14,JALISCO,8,GUADALAJARA,41,GUADALAJARA,998,384,418,0,802,379,417,0,796
14,JALISCO,8,GUADALAJARA,41,GUADALAJARA,999,827,973,1,1801,818,968,1,1787
14,JALISCO,8,GUADALAJARA,41,GUADALAJARA,1000,386,405,0,791,382,404,0,786
14,JALISCO,8,GUADALAJARA,41,GUADALAJARA,1001,589,583,0,1172,584,580,0,1164
14,JALISCO,8,GUADALAJARA,41,GUADALAJARA,1002,513,571,0,1084,509,562,0,1071
14,JALISCO,8,GUADALAJARA,41,GUADALAJARA,1003,563,599,0,1162,560,595,0,1155
14,JALISCO,8,GUADALAJARA,41,GUADALAJARA,1004,924,1028,0,1952,920,1021,0,1941
14,JALISCO,8,GUADALAJARA,41,GUADALAJARA,1005,561,672,0,1233,558,670,0,1228
14,JALISCO,8,GUADALAJARA,41,GUADALAJARA,1006,386,396,0,782,382,392,0,774
14,JALISCO,8,GUADALAJARA,41,GUADALAJARA,1007,669,717,0,1386,663,710,0,1373
14,JALISCO,8,GUADALAJARA,41,GUADALAJARA,1008,837,937,0,1774,828,930,0,1758
14,JALISCO,8,GUADALAJARA,41,GUADALAJARA,1050,355,231,0,586,354,229,0,583
14,JALISCO,8,GUADALAJARA,41,GUADALAJARA,1051,341,222,0,563,339,220,0,559
14,JALISCO,8,GUADALAJARA,41,GUADALAJARA,1052,518,382,0,900,514,377,0,891
14,JALISCO,8,GUADALAJARA,41,GUADALAJARA,1053,426,315,0,741,419,310,0,729
14,JALISCO,8,GUADALAJARA,41,GUADALAJARA,1054,334,301,0,635,331,300,0,631
14,JALISCO,8,GUADALAJARA,41,GUADALAJARA,1055,267,176,0,443,264,175,0,439
14,JALISCO,8,GUADALAJARA,41,GUADALAJARA,1056,484,394,0,878,480,393,0,873
14,JALISCO,8,GUADALAJARA,41,GUADALAJARA,1057,231,203,0,434,226,201,0,427
14,JALISCO,8,GUADALAJARA,41,GUADALAJARA,1058,486,477,0,963,482,471,0,953
14,JALISCO,8,GUADALAJARA,41,GUADALAJARA,1059,264,226,0,490,262,226,0,488
14,JALISCO,8,GUADALAJARA,41,GUADALAJARA,1060,401,349,0,750,397,347,0,744
14,JALISCO,8,GUADALAJARA,41,GUADALAJARA,1061,593,550,1,1144,588,543,1,1132
14,JALISCO,8,GUADALAJARA,41,GUADALAJARA,1062,436,403,0,839,430,402,0,832
14,JALISCO,8,GUADALAJARA,41,GUADALAJARA,1063,250,255,0,505,247,253,0,500
14,JALISCO,8,GUADALAJARA,41,GUADALAJARA,1064,440,466,0,906,434,461,0,895
14,JALISCO,8,GUADALAJARA,41,GUADALAJARA,1065,636,589,0,1225,629,584,0,1213
14,JALISCO,8,GUADALAJARA,41,GUADALAJARA,1066,611,495,1,1107,605,490,1,1096
14,JALISCO,8,GUADALAJARA,41,GUADALAJARA,1067,371,356,0,727,369,355,0,724
14,JALISCO,8,GUADALAJARA,41,GUADALAJARA,1068,416,492,0,908,410,489,0,899
14,JALISCO,8,GUADALAJARA,41,GUADALAJARA,1069,346,378,0,724,343,377,0,720
14,JALISCO,8,GUADALAJARA,41,GUADALAJARA,1070,541,498,0,1039,533,497,0,1030
14,JALISCO,8,GUADALAJARA,41,GUADALAJARA,1071,459,406,0,865,454,404,0,858
14,JALISCO,8,GUADALAJARA,41,GUADALAJARA,1072,397,390,0,787,394,385,0,779
14,JALISCO,8,GUADALAJARA,41,GUADALAJARA,1073,247,256,0,503,245,252,0,497
14,JALISCO,8,GUADALAJARA,41,GUADALAJARA,1074,456,394,0,850,453,391,0,844
14,JALISCO,8,GUADALAJARA,41,GUADALAJARA,1075,521,488,0,1009,517,486,0,1003
14,JALISCO,8,GUADALAJARA,41,GUADALAJARA,1076,360,302,0,662,357,302,0,659
14,JALISCO,8,GUADALAJARA,41,GUADALAJARA,1077,516,565,0,1081,508,559,0,1067
14,JALISCO,8,GUADALAJARA,41,GUADALAJARA,1078,513,557,0,1070,506,555,0,1061
14,JALISCO,8,GUADALAJARA,41,GUADALAJARA,1079,354,362,0,716,352,358,0,710
14,JALISCO,8,GUADALAJARA,41,GUADALAJARA,1080,310,360,0,670,307,359,0,666
14,JALISCO,8,GUADALAJARA,41,GUADALAJARA,1081,379,398,0,777,375,395,0,770
14,JALISCO,8,GUADALAJARA,41,GUADALAJARA,1082,523,546,0,1069,518,539,0,1057
14,JALISCO,8,GUADALAJARA,41,GUADALAJARA,1083,417,453,0,870,414,450,0,864
14,JALISCO,8,GUADALAJARA,41,GUADALAJARA,1084,340,375,0,715,333,375,0,708
14,JALISCO,8,GUADALAJARA,41,GUADALAJARA,1085,345,436,0,781,344,431,0,775
14,JALISCO,8,GUADALAJARA,41,GUADALAJARA,1086,547,578,0,1125,541,572,0,1113
14,JALISCO,8,GUADALAJARA,41,GUADALAJARA,1087,910,1135,0,2045,903,1126,0,2029
14,JALISCO,8,GUADALAJARA,41,GUADALAJARA,1088,1095,1402,0,2497,1079,1390,0,2469
14,JALISCO,8,GUADALAJARA,41,GUADALAJARA,1089,729,899,0,1628,724,890,0,1614
14,JALISCO,8,GUADALAJARA,41,GUADALAJARA,1090,381,464,0,845,378,461,0,839
14,JALISCO,8,GUADALAJARA,41,GUADALAJARA,1091,687,850,1,1538,686,844,1,1531
14,JALISCO,8,GUADALAJARA,41,GUADALAJARA,1092,511,586,0,1097,510,583,0,1093
14,JALISCO,8,GUADALAJARA,41,GUADALAJARA,1093,413,501,0,914,412,498,0,910
14,JALISCO,8,GUADALAJARA,41,GUADALAJARA,1094,351,392,0,743,344,389,0,733
14,JALISCO,8,GUADALAJARA,41,GUADALAJARA,1095,319,391,0,710,317,387,0,704
14,JALISCO,8,GUADALAJARA,41,GUADALAJARA,1096,435,513,0,948,432,513,0,945
14,JALISCO,8,GUADALAJARA,41,GUADALAJARA,1097,394,446,0,840,392,443,0,835
14,JALISCO,8,GUADALAJARA,41,GUADALAJARA,1098,464,569,0,1033,462,568,0,1030
14,JALISCO,8,GUADALAJARA,41,GUADALAJARA,1099,260,286,0,546,257,284,0,541
14,JALISCO,8,GUADALAJARA,41,GUADALAJARA,1100,575,666,0,1241,566,662,0,1228
14,JALISCO,8,GUADALAJARA,41,GUADALAJARA,1101,525,643,0,1168,522,641,0,1163
14,JALISCO,8,GUADALAJARA,41,GUADALAJARA,1102,574,653,0,1227,566,649,0,1215
14,JALISCO,8,GUADALAJARA,41,GUADALAJARA,1103,674,735,0,1409,668,731,0,1399
14,JALISCO,8,GUADALAJARA,41,GUADALAJARA,1104,580,650,0,1230,572,643,0,1215
14,JALISCO,8,GUADALAJARA,41,GUADALAJARA,1105,418,460,0,878,411,449,0,860
14,JALISCO,8,GUADALAJARA,41,GUADALAJARA,1106,676,747,0,1423,670,741,0,1411
14,JALISCO,8,GUADALAJARA,41,GUADALAJARA,1107,413,494,0,907,408,489,0,897
14,JALISCO,8,GUADALAJARA,41,GUADALAJARA,1108,582,729,0,1311,574,724,0,1298
14,JALISCO,8,GUADALAJARA,41,GUADALAJARA,1109,385,463,0,848,381,461,0,842
14,JALISCO,8,GUADALAJARA,41,GUADALAJARA,1110,385,416,0,801,383,413,0,796
14,JALISCO,8,GUADALAJARA,41,GUADALAJARA,1111,475,569,0,1044,471,564,0,1035
14,JALISCO,8,GUADALAJARA,41,GUADALAJARA,1112,461,494,0,955,458,492,0,950
14,JALISCO,8,GUADALAJARA,41,GUADALAJARA,1113,667,751,0,1418,663,745,0,1408
14,JALISCO,8,GUADALAJARA,41,GUADALAJARA,1114,322,375,0,697,319,371,0,690
14,JALISCO,8,GUADALAJARA,41,GUADALAJARA,1115,512,566,0,1078,511,562,0,1073
14,JALISCO,8,GUADALAJARA,41,GUADALAJARA,1116,619,738,0,1357,616,733,0,1349
14,JALISCO,8,GUADALAJARA,41,GUADALAJARA,1117,372,430,0,802,369,428,0,797
14,JALISCO,8,GUADALAJARA,41,GUADALAJARA,1118,346,416,0,762,345,414,0,759
14,JALISCO,8,GUADALAJARA,41,GUADALAJARA,1119,416,409,0,825,412,404,0,816
14,JALISCO,8,GUADALAJARA,41,GUADALAJARA,1120,407,438,0,845,407,431,0,838
14,JALISCO,8,GUADALAJARA,41,GUADALAJARA,1121,441,513,0,954,438,504,0,942
14,JALISCO,8,GUADALAJARA,41,GUADALAJARA,1122,390,481,0,871,388,477,0,865
14,JALISCO,8,GUADALAJARA,41,GUADALAJARA,1123,647,763,0,1410,642,757,0,1399
14,JALISCO,8,GUADALAJARA,41,GUADALAJARA,1124,809,902,0,1711,801,890,0,1691
14,JALISCO,8,GUADALAJARA,41,GUADALAJARA,1125,559,658,0,1217,554,657,0,1211
14,JALISCO,8,GUADALAJARA,41,GUADALAJARA,1126,591,689,0,1280,588,682,0,1270
14,JALISCO,8,GUADALAJARA,41,GUADALAJARA,1127,485,551,0,1036,483,548,0,1031
14,JALISCO,8,GUADALAJARA,41,GUADALAJARA,1128,620,718,0,1338,613,711,0,1324
14,JALISCO,8,GUADALAJARA,41,GUADALAJARA,1129,645,833,0,1478,638,830,0,1468
14,JALISCO,8,GUADALAJARA,41,GUADALAJARA,1130,405,483,0,888,400,479,0,879
14,JALISCO,8,GUADALAJARA,41,GUADALAJARA,1131,372,451,0,823,369,451,0,820
14,JALISCO,8,GUADALAJARA,41,GUADALAJARA,1132,376,399,0,775,371,396,0,767
14,JALISCO,8,GUADALAJARA,41,GUADALAJARA,1133,406,492,0,898,400,492,0,892
14,JALISCO,8,GUADALAJARA,41,GUADALAJARA,1134,215,225,0,440,214,225,0,439
14,JALISCO,8,GUADALAJARA,41,GUADALAJARA,1135,350,416,0,766,347,414,0,761
14,JALISCO,8,GUADALAJARA,41,GUADALAJARA,1136,464,510,0,974,460,507,0,967
14,JALISCO,8,GUADALAJARA,41,GUADALAJARA,1137,604,689,0,1293,597,682,0,1279
14,JALISCO,8,GUADALAJARA,41,GUADALAJARA,1138,246,250,0,496,244,248,0,492
14,JALISCO,8,GUADALAJARA,41,GUADALAJARA,1139,592,680,2,1274,586,677,2,1265
14,JALISCO,8,GUADALAJARA,41,GUADALAJARA,1140,564,609,0,1173,562,602,0,1164
14,JALISCO,8,GUADALAJARA,41,GUADALAJARA,1141,409,499,1,909,408,493,1,902
14,JALISCO,8,GUADALAJARA,41,GUADALAJARA,1142,487,602,0,1089,485,602,0,1087
14,JALISCO,8,GUADALAJARA,41,GUADALAJARA,1143,469,542,0,1011,465,540,0,1005
14,JALISCO,8,GUADALAJARA,41,GUADALAJARA,1144,477,539,0,1016,469,527,0,996
14,JALISCO,8,GUADALAJARA,41,GUADALAJARA,1145,448,565,0,1013,443,559,0,1002
14,JALISCO,8,GUADALAJARA,41,GUADALAJARA,1146,339,437,0,776,330,433,0,763
14,JALISCO,8,GUADALAJARA,41,GUADALAJARA,1147,481,543,0,1024,476,539,0,1015
14,JALISCO,8,GUADALAJARA,41,GUADALAJARA,1148,457,539,0,996,451,530,0,981
14,JALISCO,8,GUADALAJARA,41,GUADALAJARA,1149,399,398,0,797,394,397,0,791
14,JALISCO,8,GUADALAJARA,41,GUADALAJARA,1150,562,673,1,1236,558,664,1,1223
14,JALISCO,8,GUADALAJARA,41,GUADALAJARA,1151,559,663,0,1222,555,660,0,1215
14,JALISCO,8,GUADALAJARA,41,GUADALAJARA,1152,493,580,0,1073,487,574,0,1061
14,JALISCO,8,GUADALAJARA,41,GUADALAJARA,1153,530,568,0,1098,529,565,0,1094
14,JALISCO,8,GUADALAJARA,41,GUADALAJARA,1154,557,591,0,1148,553,588,0,1141
14,JALISCO,8,GUADALAJARA,41,GUADALAJARA,1155,334,415,0,749,331,413,0,744
14,JALISCO,8,GUADALAJARA,41,GUADALAJARA,1156,467,462,0,929,461,459,0,920
14,JALISCO,8,GUADALAJARA,41,GUADALAJARA,1157,327,383,0,710,324,381,0,705
14,JALISCO,8,GUADALAJARA,41,GUADALAJARA,1158,386,411,0,797,384,408,0,792
14,JALISCO,8,GUADALAJARA,41,GUADALAJARA,1159,551,556,0,1107,545,554,0,1099
14,JALISCO,8,GUADALAJARA,41,GUADALAJARA,1160,326,365,0,691,325,360,0,685
14,JALISCO,8,GUADALAJARA,41,GUADALAJARA,1161,447,582,0,1029,446,582,0,1028
14,JALISCO,8,GUADALAJARA,41,GUADALAJARA,1162,492,586,0,1078,492,585,0,1077
14,JALISCO,8,GUADALAJARA,41,GUADALAJARA,1163,487,558,0,1045,483,555,0,1038
14,JALISCO,8,GUADALAJARA,41,GUADALAJARA,1164,488,597,0,1085,486,593,0,1079
14,JALISCO,8,GUADALAJARA,41,GUADALAJARA,1165,525,615,0,1140,516,612,0,1128
14,JALISCO,8,GUADALAJARA,41,GUADALAJARA,1166,546,534,0,1080,535,527,0,1062
14,JALISCO,8,GUADALAJARA,41,GUADALAJARA,1167,304,320,0,624,299,317,0,616
14,JALISCO,8,GUADALAJARA,41,GUADALAJARA,1168,263,271,0,534,261,269,0,530
14,JALISCO,8,GUADALAJARA,41,GUADALAJARA,1169,379,420,0,799,374,416,0,790
14,JALISCO,8,GUADALAJARA,41,GUADALAJARA,1170,347,371,0,718,344,366,0,710
14,JALISCO,8,GUADALAJARA,41,GUADALAJARA,1171,444,477,0,921,435,474,0,909
14,JALISCO,8,GUADALAJARA,41,GUADALAJARA,1172,398,447,0,845,396,445,0,841
14,JALISCO,8,GUADALAJARA,41,GUADALAJARA,1173,402,431,0,833,396,426,0,822
14,JALISCO,8,GUADALAJARA,41,GUADALAJARA,1174,426,486,0,912,423,481,0,904
14,JALISCO,8,GUADALAJARA,41,GUADALAJARA,1175,514,636,0,1150,512,634,0,1146
14,JALISCO,8,GUADALAJARA,41,GUADALAJARA,1176,609,666,0,1275,600,658,0,1258
14,JALISCO,8,GUADALAJARA,41,GUADALAJARA,1177,449,479,0,928,445,478,0,923
14,JALISCO,8,GUADALAJARA,41,GUADALAJARA,1178,443,470,0,913,441,465,0,906
14,JALISCO,8,GUADALAJARA,41,GUADALAJARA,1179,439,452,0,891,435,446,0,881
14,JALISCO,8,GUADALAJARA,41,GUADALAJARA,1180,590,669,0,1259,584,665,0,1249
14,JALISCO,8,GUADALAJARA,41,GUADALAJARA,1181,232,229,0,461,232,229,0,461
14,JALISCO,8,GUADALAJARA,41,GUADALAJARA,1182,273,271,0,544,266,269,0,535
14,JALISCO,8,GUADALAJARA,41,GUADALAJARA,1183,271,279,0,550,268,276,0,544
14,JALISCO,8,GUADALAJARA,41,GUADALAJARA,1184,254,254,0,508,254,254,0,508
14,JALISCO,8,GUADALAJARA,41,GUADALAJARA,1185,273,314,0,587,269,310,0,579
14,JALISCO,8,GUADALAJARA,41,GUADALAJARA,1186,246,246,0,492,244,246,0,490
14,JALISCO,8,GUADALAJARA,41,GUADALAJARA,1357,582,749,0,1331,575,743,0,1318
14,JALISCO,8,GUADALAJARA,41,GUADALAJARA,1358,597,728,0,1325,592,720,0,1312
14,JALISCO,8,GUADALAJARA,41,GUADALAJARA,1359,514,605,0,1119,510,603,0,1113
14,JALISCO,8,GUADALAJARA,41,GUADALAJARA,1360,547,607,0,1154,543,603,0,1146
14,JALISCO,8,GUADALAJARA,41,GUADALAJARA,1361,653,700,0,1353,645,697,0,1342
14,JALISCO,8,GUADALAJARA,41,GUADALAJARA,1526,725,790,1,1516,718,785,1,1504
14,JALISCO,8,GUADALAJARA,41,GUADALAJARA,1527,356,371,0,727,352,368,0,720
14,JALISCO,8,GUADALAJARA,41,GUADALAJARA,1528,495,546,0,1041,493,541,0,1034
14,JALISCO,8,GUADALAJARA,41,GUADALAJARA,1529,375,452,0,827,374,447,0,821
14,JALISCO,8,GUADALAJARA,41,GUADALAJARA,1530,420,449,0,869,414,447,0,861
14,JALISCO,8,GUADALAJARA,41,GUADALAJARA,1531,490,580,0,1070,489,578,0,1067
14,JALISCO,8,GUADALAJARA,41,GUADALAJARA,1532,326,355,0,681,322,352,0,674
14,JALISCO,8,GUADALAJARA,41,GUADALAJARA,1533,314,331,0,645,310,328,0,638
14,JALISCO,8,GUADALAJARA,41,GUADALAJARA,1534,806,897,0,1703,803,892,0,1695
14,JALISCO,8,GUADALAJARA,41,GUADALAJARA,1535,682,730,0,1412,677,725,0,1402
14,JALISCO,8,GUADALAJARA,41,GUADALAJARA,1536,537,565,0,1102,535,562,0,1097
14,JALISCO,8,GUADALAJARA,41,GUADALAJARA,1537,441,498,0,939,435,494,0,929
14,JALISCO,8,GUADALAJARA,41,GUADALAJARA,1538,502,557,0,1059,498,555,0,1053
14,JALISCO,8,GUADALAJARA,41,GUADALAJARA,1539,657,754,0,1411,653,748,0,1401
14,JALISCO,8,GUADALAJARA,41,GUADALAJARA,1540,409,450,0,859,404,449,0,853
14,JALISCO,8,GUADALAJARA,41,GUADALAJARA,1541,476,580,0,1056,476,575,0,1051
14,JALISCO,8,GUADALAJARA,41,GUADALAJARA,1542,519,548,0,1067,517,543,0,1060
14,JALISCO,8,GUADALAJARA,41,GUADALAJARA,1543,460,499,0,959,455,494,0,949
14,JALISCO,8,GUADALAJARA,41,GUADALAJARA,1544,486,513,0,999,480,511,0,991
14,JALISCO,8,GUADALAJARA,41,GUADALAJARA,1545,708,771,0,1479,699,760,0,1459
14,JALISCO,8,GUADALAJARA,41,GUADALAJARA,1546,459,493,0,952,453,489,0,942
14,JALISCO,8,GUADALAJARA,41,GUADALAJARA,1547,429,514,0,943,427,513,0,940
14,JALISCO,8,GUADALAJARA,41,GUADALAJARA,1548,546,621,0,1167,542,620,0,1162
14,JALISCO,8,GUADALAJARA,41,GUADALAJARA,3356,244,269,0,513,243,266,0,509
14,JALISCO,9,GUADALAJARA,41,GUADALAJARA,633,516,560,0,1076,516,557,0,1073
14,JALISCO,9,GUADALAJARA,41,GUADALAJARA,634,451,506,0,957,446,503,0,949
14,JALISCO,9,GUADALAJARA,41,GUADALAJARA,635,576,597,0,1173,572,593,0,1165
14,JALISCO,9,GUADALAJARA,41,GUADALAJARA,636,462,454,0,916,457,453,0,910
14,JALISCO,9,GUADALAJARA,41,GUADALAJARA,637,986,1062,0,2048,981,1053,0,2034
14,JALISCO,9,GUADALAJARA,41,GUADALAJARA,638,918,1071,0,1989,910,1066,0,1976
14,JALISCO,9,GUADALAJARA,41,GUADALAJARA,639,494,553,0,1047,488,550,0,1038
14,JALISCO,9,GUADALAJARA,41,GUADALAJARA,640,564,564,0,1128,562,556,0,1118
14,JALISCO,9,GUADALAJARA,41,GUADALAJARA,641,760,785,0,1545,756,777,0,1533
14,JALISCO,9,GUADALAJARA,41,GUADALAJARA,642,830,880,0,1710,820,874,0,1694
14,JALISCO,9,GUADALAJARA,41,GUADALAJARA,643,669,693,0,1362,663,688,0,1351
14,JALISCO,9,GUADALAJARA,41,GUADALAJARA,644,670,701,0,1371,662,696,0,1358
14,JALISCO,9,GUADALAJARA,41,GUADALAJARA,645,838,907,0,1745,831,902,0,1733
14,JALISCO,9,GUADALAJARA,41,GUADALAJARA,646,718,729,0,1447,712,724,0,1436
14,JALISCO,9,GUADALAJARA,41,GUADALAJARA,647,893,957,0,1850,883,949,0,1832
14,JALISCO,9,GUADALAJARA,41,GUADALAJARA,648,708,743,0,1451,703,741,0,1444
14,JALISCO,9,GUADALAJARA,41,GUADALAJARA,649,754,805,0,1559,749,799,0,1548
14,JALISCO,9,GUADALAJARA,41,GUADALAJARA,650,781,753,0,1534,778,748,0,1526
14,JALISCO,9,GUADALAJARA,41,GUADALAJARA,651,658,709,0,1367,650,699,0,1349
14,JALISCO,9,GUADALAJARA,41,GUADALAJARA,652,656,694,0,1350,650,693,0,1343
14,JALISCO,9,GUADALAJARA,41,GUADALAJARA,653,966,1074,0,2040,959,1069,0,2028
14,JALISCO,9,GUADALAJARA,41,GUADALAJARA,654,509,590,0,1099,507,588,0,1095
14,JALISCO,9,GUADALAJARA,41,GUADALAJARA,655,800,844,1,1645,792,842,1,1635
14,JALISCO,9,GUADALAJARA,41,GUADALAJARA,656,457,471,0,928,451,468,0,919
14,JALISCO,9,GUADALAJARA,41,GUADALAJARA,657,139,133,0,272,139,133,0,272
14,JALISCO,9,GUADALAJARA,41,GUADALAJARA,658,163,196,0,359,162,195,0,357
14,JALISCO,9,GUADALAJARA,41,GUADALAJARA,659,254,278,0,532,250,276,0,526
14,JALISCO,9,GUADALAJARA,41,GUADALAJARA,660,632,653,0,1285,625,644,0,1269
14,JALISCO,9,GUADALAJARA,41,GUADALAJARA,661,688,723,0,1411,683,716,0,1399
14,JALISCO,9,GUADALAJARA,41,GUADALAJARA,662,558,518,0,1076,555,505,0,1060
14,JALISCO,9,GUADALAJARA,41,GUADALAJARA,663,810,840,0,1650,805,833,0,1638
14,JALISCO,9,GUADALAJARA,41,GUADALAJARA,664,897,899,0,1796,884,895,0,1779
14,JALISCO,9,GUADALAJARA,41,GUADALAJARA,708,504,574,0,1078,502,573,0,1075
14,JALISCO,9,GUADALAJARA,41,GUADALAJARA,709,421,494,0,915,418,493,0,911
14,JALISCO,9,GUADALAJARA,41,GUADALAJARA,710,988,1109,0,2097,984,1099,0,2083
14,JALISCO,9,GUADALAJARA,41,GUADALAJARA,711,693,763,0,1456,687,751,0,1438
14,JALISCO,9,GUADALAJARA,41,GUADALAJARA,712,2068,2204,0,4272,2053,2184,0,4237
14,JALISCO,9,GUADALAJARA,41,GUADALAJARA,713,524,564,0,1088,520,557,0,1077
14,JALISCO,9,GUADALAJARA,41,GUADALAJARA,714,475,491,0,966,473,486,0,959
14,JALISCO,9,GUADALAJARA,41,GUADALAJARA,715,424,436,0,860,418,433,0,851
14,JALISCO,9,GUADALAJARA,41,GUADALAJARA,716,654,813,0,1467,649,810,0,1459
14,JALISCO,9,GUADALAJARA,41,GUADALAJARA,717,649,687,0,1336,641,683,0,1324
14,JALISCO,9,GUADALAJARA,41,GUADALAJARA,718,567,646,0,1213,561,638,0,1199
14,JALISCO,9,GUADALAJARA,41,GUADALAJARA,719,441,462,0,903,439,460,0,899
14,JALISCO,9,GUADALAJARA,41,GUADALAJARA,720,663,756,0,1419,658,751,0,1409
14,JALISCO,9,GUADALAJARA,41,GUADALAJARA,1187,1359,1367,0,2726,1348,1355,0,2703
14,JALISCO,9,GUADALAJARA,41,GUADALAJARA,1188,979,1016,0,1995,971,1007,0,1978
14,JALISCO,9,GUADALAJARA,41,GUADALAJARA,1189,865,986,0,1851,860,971,0,1831
14,JALISCO,9,GUADALAJARA,41,GUADALAJARA,1190,657,674,0,1331,652,665,0,1317
14,JALISCO,9,GUADALAJARA,41,GUADALAJARA,1191,719,681,0,1400,704,674,0,1378
14,JALISCO,9,GUADALAJARA,41,GUADALAJARA,1192,1211,1294,0,2505,1206,1282,0,2488
14,JALISCO,9,GUADALAJARA,41,GUADALAJARA,1195,651,765,0,1416,643,757,0,1400
14,JALISCO,9,GUADALAJARA,41,GUADALAJARA,1196,1429,1583,0,3012,1420,1570,0,2990
14,JALISCO,9,GUADALAJARA,41,GUADALAJARA,1197,1911,2040,0,3951,1883,2015,0,3898
14,JALISCO,9,GUADALAJARA,41,GUADALAJARA,1198,1161,1271,0,2432,1156,1260,0,2416
14,JALISCO,9,GUADALAJARA,41,GUADALAJARA,1199,718,732,0,1450,714,729,0,1443
14,JALISCO,9,GUADALAJARA,41,GUADALAJARA,1200,1463,1594,0,3057,1451,1579,0,3030
14,JALISCO,9,GUADALAJARA,41,GUADALAJARA,1201,959,1103,0,2062,953,1097,0,2050
14,JALISCO,9,GUADALAJARA,41,GUADALAJARA,1202,662,723,0,1385,654,715,0,1369
14,JALISCO,9,GUADALAJARA,41,GUADALAJARA,1203,612,637,0,1249,607,633,0,1240
14,JALISCO,9,GUADALAJARA,41,GUADALAJARA,1204,952,1062,0,2014,944,1044,0,1988
14,JALISCO,9,GUADALAJARA,41,GUADALAJARA,1205,1079,1139,0,2218,1065,1136,0,2201
14,JALISCO,9,GUADALAJARA,41,GUADALAJARA,1206,1028,1089,0,2117,1020,1071,0,2091
14,JALISCO,9,GUADALAJARA,41,GUADALAJARA,1207,1268,1331,0,2599,1256,1317,0,2573
14,JALISCO,9,GUADALAJARA,41,GUADALAJARA,1208,1081,1081,0,2162,1071,1074,0,2145
14,JALISCO,9,GUADALAJARA,41,GUADALAJARA,1209,1212,1206,0,2418,1197,1199,0,2396
14,JALISCO,9,GUADALAJARA,41,GUADALAJARA,1210,615,675,0,1290,614,671,0,1285
14,JALISCO,9,GUADALAJARA,41,GUADALAJARA,1211,618,683,1,1302,613,681,1,1295
14,JALISCO,9,GUADALAJARA,41,GUADALAJARA,1212,441,488,0,929,438,484,0,922
14,JALISCO,9,GUADALAJARA,41,GUADALAJARA,1213,1124,1236,0,2360,1114,1228,0,2342
14,JALISCO,9,GUADALAJARA,41,GUADALAJARA,1214,797,846,0,1643,789,840,0,1629
14,JALISCO,9,GUADALAJARA,41,GUADALAJARA,1215,608,640,0,1248,603,636,0,1239
14,JALISCO,9,GUADALAJARA,41,GUADALAJARA,1216,1318,1287,0,2605,1302,1281,0,2583
14,JALISCO,9,GUADALAJARA,41,GUADALAJARA,1217,1174,1312,0,2486,1165,1299,0,2464
14,JALISCO,9,GUADALAJARA,41,GUADALAJARA,1218,1009,1060,0,2069,1002,1045,0,2047
14,JALISCO,9,GUADALAJARA,41,GUADALAJARA,1219,1172,1261,0,2433,1155,1245,0,2400
14,JALISCO,9,GUADALAJARA,41,GUADALAJARA,1220,906,948,0,1854,900,943,0,1843
14,JALISCO,9,GUADALAJARA,41,GUADALAJARA,1221,709,711,0,1420,702,707,0,1409
14,JALISCO,9,GUADALAJARA,41,GUADALAJARA,1222,448,477,0,925,444,472,0,916
14,JALISCO,9,GUADALAJARA,41,GUADALAJARA,1223,587,701,0,1288,581,695,0,1276
14,JALISCO,9,GUADALAJARA,41,GUADALAJARA,1224,1984,2157,0,4141,1965,2140,0,4105
14,JALISCO,9,GUADALAJARA,41,GUADALAJARA,1225,529,612,0,1141,522,605,0,1127
14,JALISCO,9,GUADALAJARA,41,GUADALAJARA,1226,455,536,0,991,451,533,0,984
14,JALISCO,9,GUADALAJARA,41,GUADALAJARA,1227,939,990,0,1929,930,980,0,1910
14,JALISCO,9,GUADALAJARA,41,GUADALAJARA,1228,595,643,0,1238,586,639,0,1225
14,JALISCO,9,GUADALAJARA,41,GUADALAJARA,1229,588,636,0,1224,577,633,0,1210
14,JALISCO,9,GUADALAJARA,41,GUADALAJARA,1230,539,589,0,1128,533,582,0,1115
14,JALISCO,9,GUADALAJARA,41,GUADALAJARA,1231,449,470,0,919,445,469,0,914
14,JALISCO,9,GUADALAJARA,41,GUADALAJARA,1232,449,500,0,949,444,496,0,940
14,JALISCO,9,GUADALAJARA,41,GUADALAJARA,1233,1214,1244,0,2458,1199,1235,0,2434
14,JALISCO,9,GUADALAJARA,41,GUADALAJARA,1234,926,981,0,1907,923,971,0,1894
14,JALISCO,9,GUADALAJARA,41,GUADALAJARA,1235,881,903,0,1784,875,897,0,1772
14,JALISCO,9,GUADALAJARA,41,GUADALAJARA,1236,864,846,0,1710,856,829,0,1685
14,JALISCO,9,GUADALAJARA,41,GUADALAJARA,1237,845,817,0,1662,840,807,0,1647
14,JALISCO,9,GUADALAJARA,41,GUADALAJARA,1238,1093,1201,0,2294,1078,1194,0,2272
14,JALISCO,9,GUADALAJARA,41,GUADALAJARA,1239,801,821,0,1622,793,813,0,1606
14,JALISCO,9,GUADALAJARA,41,GUADALAJARA,1240,644,634,0,1278,637,630,0,1267
14,JALISCO,9,GUADALAJARA,41,GUADALAJARA,1241,520,593,1,1114,515,589,1,1105
14,JALISCO,9,GUADALAJARA,41,GUADALAJARA,1242,1603,1693,0,3296,1591,1680,0,3271
14,JALISCO,9,GUADALAJARA,41,GUADALAJARA,1243,956,987,0,1943,945,977,0,1922
14,JALISCO,9,GUADALAJARA,41,GUADALAJARA,1244,994,1001,0,1995,986,990,0,1976
14,JALISCO,9,GUADALAJARA,41,GUADALAJARA,1245,649,676,0,1325,645,669,0,1314
14,JALISCO,9,GUADALAJARA,41,GUADALAJARA,1246,556,632,0,1188,548,623,0,1171
14,JALISCO,9,GUADALAJARA,41,GUADALAJARA,1247,1475,1756,0,3231,1464,1746,0,3210
14,JALISCO,9,GUADALAJARA,41,GUADALAJARA,1248,1186,1355,0,2541,1175,1340,0,2515
14,JALISCO,9,GUADALAJARA,41,GUADALAJARA,1249,1206,1271,0,2477,1196,1254,0,2450
14,JALISCO,9,GUADALAJARA,41,GUADALAJARA,1250,524,573,0,1097,519,563,0,1082
14,JALISCO,9,GUADALAJARA,41,GUADALAJARA,1251,611,645,0,1256,604,640,0,1244
14,JALISCO,9,GUADALAJARA,41,GUADALAJARA,1252,941,1057,0,1998,933,1046,0,1979
14,JALISCO,9,GUADALAJARA,41,GUADALAJARA,1253,415,527,0,942,409,519,0,928
14,JALISCO,9,GUADALAJARA,41,GUADALAJARA,1254,446,496,0,942,439,494,0,933
14,JALISCO,9,GUADALAJARA,41,GUADALAJARA,1255,919,1035,0,1954,911,1025,0,1936
14,JALISCO,9,GUADALAJARA,41,GUADALAJARA,1256,892,1002,0,1894,885,997,0,1882
14,JALISCO,9,GUADALAJARA,41,GUADALAJARA,1257,611,765,0,1376,605,758,0,1363
14,JALISCO,9,GUADALAJARA,41,GUADALAJARA,1258,275,353,0,628,270,352,0,622
14,JALISCO,9,GUADALAJARA,41,GUADALAJARA,1259,167,214,0,381,167,214,0,381
14,JALISCO,9,GUADALAJARA,41,GUADALAJARA,1260,594,655,0,1249,588,652,0,1240
14,JALISCO,9,GUADALAJARA,41,GUADALAJARA,1261,1172,1290,0,2462,1163,1270,0,2433
14,JALISCO,9,GUADALAJARA,41,GUADALAJARA,1262,974,966,0,1940,968,959,0,1927
14,JALISCO,9,GUADALAJARA,41,GUADALAJARA,1263,508,518,0,1026,501,513,0,1014
14,JALISCO,9,GUADALAJARA,41,GUADALAJARA,1264,466,476,0,942,461,470,0,931
14,JALISCO,9,GUADALAJARA,41,GUADALAJARA,1265,676,707,0,1383,665,704,0,1369
14,JALISCO,9,GUADALAJARA,41,GUADALAJARA,1266,555,573,0,1128,549,569,0,1118
14,JALISCO,9,GUADALAJARA,41,GUADALAJARA,1267,1022,1064,0,2086,1012,1055,0,2067
14,JALISCO,9,GUADALAJARA,41,GUADALAJARA,1268,769,809,0,1578,763,804,0,1567
14,JALISCO,9,GUADALAJARA,41,GUADALAJARA,1269,659,707,1,1367,651,697,1,1349
14,JALISCO,9,GUADALAJARA,41,GUADALAJARA,1270,816,928,0,1744,810,914,0,1724
14,JALISCO,9,GUADALAJARA,41,GUADALAJARA,1271,775,874,0,1649,769,870,0,1639
14,JALISCO,9,GUADALAJARA,41,GUADALAJARA,1272,815,903,0,1718,809,896,0,1705
14,JALISCO,9,GUADALAJARA,41,GUADALAJARA,1273,888,935,0,1823,878,930,0,1808
14,JALISCO,9,GUADALAJARA,41,GUADALAJARA,1274,747,855,0,1602,743,851,0,1594
14,JALISCO,9,GUADALAJARA,41,GUADALAJARA,1275,655,649,0,1304,649,645,0,1294
14,JALISCO,9,GUADALAJARA,41,GUADALAJARA,1276,559,620,0,1179,555,616,0,1171
14,JALISCO,9,GUADALAJARA,41,GUADALAJARA,1277,697,741,0,1438,684,735,0,1419
14,JALISCO,9,GUADALAJARA,41,GUADALAJARA,1278,931,1012,0,1943,925,1004,0,1929
14,JALISCO,9,GUADALAJARA,41,GUADALAJARA,1279,637,639,0,1276,630,633,0,1263
14,JALISCO,9,GUADALAJARA,41,GUADALAJARA,1280,795,843,0,1638,788,837,0,1625
14,JALISCO,9,GUADALAJARA,41,GUADALAJARA,1281,521,555,0,1076,518,550,0,1068
14,JALISCO,9,GUADALAJARA,41,GUADALAJARA,1282,378,406,0,784,375,401,0,776
14,JALISCO,9,GUADALAJARA,41,GUADALAJARA,1283,774,887,0,1661,769,880,0,1649
14,JALISCO,9,GUADALAJARA,41,GUADALAJARA,1284,506,511,0,1017,500,506,0,1006
14,JALISCO,9,GUADALAJARA,41,GUADALAJARA,1285,433,526,0,959,430,523,0,953
14,JALISCO,9,GUADALAJARA,41,GUADALAJARA,1286,506,521,0,1027,495,516,0,1011
14,JALISCO,9,GUADALAJARA,41,GUADALAJARA,1287,489,569,0,1058,488,561,0,1049
14,JALISCO,9,GUADALAJARA,41,GUADALAJARA,1288,783,862,0,1645,779,854,0,1633
14,JALISCO,9,GUADALAJARA,41,GUADALAJARA,1289,657,703,0,1360,653,695,0,1348
14,JALISCO,9,GUADALAJARA,41,GUADALAJARA,1290,514,547,0,1061,507,545,0,1052
14,JALISCO,9,GUADALAJARA,41,GUADALAJARA,1291,618,685,0,1303,615,678,0,1293
14,JALISCO,9,GUADALAJARA,41,GUADALAJARA,1292,830,826,0,1656,824,817,0,1641
14,JALISCO,9,GUADALAJARA,41,GUADALAJARA,1293,738,878,0,1616,735,866,0,1601
14,JALISCO,9,GUADALAJARA,41,GUADALAJARA,1294,440,516,0,956,435,512,0,947
14,JALISCO,9,GUADALAJARA,41,GUADALAJARA,1295,447,498,0,945,443,497,0,940
14,JALISCO,9,GUADALAJARA,41,GUADALAJARA,1296,538,623,0,1161,529,619,0,1148
14,JALISCO,9,GUADALAJARA,41,GUADALAJARA,1297,572,729,0,1301,568,722,0,1290
14,JALISCO,9,GUADALAJARA,41,GUADALAJARA,1298,511,545,0,1056,506,541,0,1047
14,JALISCO,9,GUADALAJARA,41,GUADALAJARA,1299,352,456,0,808,349,451,0,800
14,JALISCO,9,GUADALAJARA,41,GUADALAJARA,1300,464,513,0,977,460,510,0,970
14,JALISCO,9,GUADALAJARA,41,GUADALAJARA,1301,392,492,0,884,388,487,0,875
14,JALISCO,9,GUADALAJARA,41,GUADALAJARA,1302,431,525,0,956,425,519,0,944
14,JALISCO,9,GUADALAJARA,41,GUADALAJARA,1303,593,701,0,1294,587,696,0,1283
14,JALISCO,9,GUADALAJARA,41,GUADALAJARA,1304,499,535,0,1034,497,530,0,1027
14,JALISCO,9,GUADALAJARA,41,GUADALAJARA,1305,446,544,0,990,439,540,0,979
14,JALISCO,9,GUADALAJARA,41,GUADALAJARA,1306,426,519,0,945,418,513,0,931
14,JALISCO,9,GUADALAJARA,41,GUADALAJARA,1307,740,910,0,1650,737,895,0,1632
14,JALISCO,9,GUADALAJARA,41,GUADALAJARA,1308,474,591,1,1066,471,586,1,1058
14,JALISCO,9,GUADALAJARA,41,GUADALAJARA,1309,826,975,0,1801,815,972,0,1787
14,JALISCO,9,GUADALAJARA,41,GUADALAJARA,1310,722,902,0,1624,718,891,0,1609
14,JALISCO,9,GUADALAJARA,41,GUADALAJARA,1311,506,525,0,1031,500,518,0,1018
14,JALISCO,9,GUADALAJARA,41,GUADALAJARA,1312,425,473,0,898,421,471,0,892
14,JALISCO,9,GUADALAJARA,41,GUADALAJARA,1313,501,509,0,1010,493,501,0,994
14,JALISCO,9,GUADALAJARA,41,GUADALAJARA,1314,396,401,0,797,394,399,0,793
14,JALISCO,9,GUADALAJARA,41,GUADALAJARA,1315,645,704,0,1349,632,694,0,1326
14,JALISCO,9,GUADALAJARA,41,GUADALAJARA,1316,463,505,0,968,458,501,0,959
14,JALISCO,9,GUADALAJARA,41,GUADALAJARA,1317,528,613,0,1141,524,609,0,1133
14,JALISCO,9,GUADALAJARA,41,GUADALAJARA,1318,763,787,0,1550,755,782,0,1537
14,JALISCO,9,GUADALAJARA,41,GUADALAJARA,1319,711,777,0,1488,706,771,0,1477
14,JALISCO,9,GUADALAJARA,41,GUADALAJARA,1320,649,720,0,1369,645,716,0,1361
14,JALISCO,9,GUADALAJARA,41,GUADALAJARA,1321,471,532,0,1003,469,528,0,997
14,JALISCO,9,GUADALAJARA,41,GUADALAJARA,1322,433,450,0,883,428,450,0,878
14,JALISCO,9,GUADALAJARA,41,GUADALAJARA,1323,483,502,0,985,477,498,0,975
14,JALISCO,9,GUADALAJARA,41,GUADALAJARA,1324,479,482,0,961,477,481,0,958
14,JALISCO,9,GUADALAJARA,41,GUADALAJARA,1325,649,680,0,1329,640,672,0,1312
14,JALISCO,9,GUADALAJARA,41,GUADALAJARA,1326,611,649,0,1260,604,645,0,1249
14,JALISCO,9,GUADALAJARA,41,GUADALAJARA,1327,1047,1225,0,2272,1037,1216,0,2253
14,JALISCO,9,GUADALAJARA,41,GUADALAJARA,1328,1352,1401,0,2753,1337,1389,0,2726
14,JALISCO,9,GUADALAJARA,41,GUADALAJARA,1329,754,813,0,1567,745,808,0,1553
14,JALISCO,9,GUADALAJARA,41,GUADALAJARA,1330,1099,1116,0,2215,1088,1109,0,2197
14,JALISCO,9,GUADALAJARA,41,GUADALAJARA,1331,2039,2099,0,4138,2012,2079,0,4091
14,JALISCO,9,GUADALAJARA,41,GUADALAJARA,1332,1276,1367,0,2643,1261,1360,0,2621
14,JALISCO,9,GUADALAJARA,41,GUADALAJARA,1333,1365,1463,0,2828,1357,1453,0,2810
14,JALISCO,9,GUADALAJARA,41,GUADALAJARA,1334,755,768,1,1524,746,759,1,1506
14,JALISCO,9,GUADALAJARA,41,GUADALAJARA,1335,729,777,0,1506,723,774,0,1497
14,JALISCO,9,GUADALAJARA,41,GUADALAJARA,1336,1262,1235,0,2497,1248,1225,0,2473
14,JALISCO,9,GUADALAJARA,41,GUADALAJARA,1337,632,727,0,1359,627,720,0,1347
14,JALISCO,9,GUADALAJARA,41,GUADALAJARA,1338,527,531,0,1058,523,527,0,1050
14,JALISCO,9,GUADALAJARA,41,GUADALAJARA,1339,670,680,0,1350,665,675,0,1340
14,JALISCO,9,GUADALAJARA,41,GUADALAJARA,1340,785,827,0,1612,772,822,0,1594
14,JALISCO,9,GUADALAJARA,41,GUADALAJARA,1341,689,701,0,1390,682,694,0,1376
14,JALISCO,9,GUADALAJARA,41,GUADALAJARA,1342,644,673,0,1317,638,662,0,1300
14,JALISCO,9,GUADALAJARA,41,GUADALAJARA,1343,682,806,0,1488,676,797,0,1473
14,JALISCO,9,GUADALAJARA,41,GUADALAJARA,1344,765,843,0,1608,755,832,0,1587
14,JALISCO,9,GUADALAJARA,41,GUADALAJARA,1345,895,912,0,1807,888,903,0,1791
14,JALISCO,9,GUADALAJARA,41,GUADALAJARA,1346,735,790,0,1525,732,785,0,1517
14,JALISCO,9,GUADALAJARA,41,GUADALAJARA,1347,850,892,0,1742,842,883,0,1725
14,JALISCO,9,GUADALAJARA,41,GUADALAJARA,1348,592,679,0,1271,590,674,0,1264
14,JALISCO,9,GUADALAJARA,41,GUADALAJARA,1349,573,624,0,1197,571,621,0,1192
14,JALISCO,9,GUADALAJARA,41,GUADALAJARA,1350,503,596,0,1099,498,589,0,1087
14,JALISCO,9,GUADALAJARA,41,GUADALAJARA,1351,551,659,0,1210,548,652,0,1200
14,JALISCO,9,GUADALAJARA,41,GUADALAJARA,1352,479,580,0,1059,473,574,0,1047
14,JALISCO,9,GUADALAJARA,41,GUADALAJARA,1353,708,799,0,1507,703,797,0,1500
14,JALISCO,9,GUADALAJARA,41,GUADALAJARA,1354,379,432,0,811,376,431,0,807
14,JALISCO,9,GUADALAJARA,41,GUADALAJARA,1355,519,589,0,1108,513,586,0,1099
14,JALISCO,9,GUADALAJARA,41,GUADALAJARA,1356,424,525,0,949,421,518,0,939
14,JALISCO,9,GUADALAJARA,41,GUADALAJARA,1362,469,488,0,957,461,485,0,946
14,JALISCO,9,GUADALAJARA,41,GUADALAJARA,1363,394,447,0,841,387,444,0,831
14,JALISCO,9,GUADALAJARA,41,GUADALAJARA,1364,683,676,0,1359,681,675,0,1356
14,JALISCO,9,GUADALAJARA,41,GUADALAJARA,1365,683,787,0,1470,673,779,0,1452
14,JALISCO,9,GUADALAJARA,41,GUADALAJARA,1366,463,494,0,957,458,490,0,948
14,JALISCO,9,GUADALAJARA,41,GUADALAJARA,1367,331,327,0,658,328,324,0,652
14,JALISCO,9,GUADALAJARA,41,GUADALAJARA,1368,566,639,0,1205,560,633,0,1193
14,JALISCO,9,GUADALAJARA,41,GUADALAJARA,1369,396,452,0,848,394,447,0,841
14,JALISCO,9,GUADALAJARA,41,GUADALAJARA,1370,449,520,0,969,442,515,0,957
14,JALISCO,9,GUADALAJARA,41,GUADALAJARA,1371,965,1009,0,1974,958,1001,0,1959
14,JALISCO,9,GUADALAJARA,41,GUADALAJARA,1372,635,644,0,1279,632,640,0,1272
14,JALISCO,9,GUADALAJARA,41,GUADALAJARA,1373,776,852,0,1628,768,845,0,1613
14,JALISCO,9,GUADALAJARA,41,GUADALAJARA,3716,1345,1507,0,2852,1326,1493,0,2819
14,JALISCO,9,GUADALAJARA,41,GUADALAJARA,3717,1269,1419,1,2689,1251,1406,1,2658
14,JALISCO,9,GUADALAJARA,41,GUADALAJARA,3718,949,1042,0,1991,942,1030,0,1972
14,JALISCO,9,GUADALAJARA,41,GUADALAJARA,3719,977,1127,1,2105,968,1120,1,2089
14,JALISCO,9,GUADALAJARA,41,GUADALAJARA,3720,873,930,0,1803,865,927,0,1792
14,JALISCO,10,ZAPOPAN,120,ZAPOPAN,2900,634,719,0,1353,626,707,0,1333
14,JALISCO,10,ZAPOPAN,120,ZAPOPAN,2901,509,546,0,1055,507,539,0,1046
14,JALISCO,10,ZAPOPAN,120,ZAPOPAN,2902,1293,1315,0,2608,1282,1306,0,2588
14,JALISCO,10,ZAPOPAN,120,ZAPOPAN,2903,799,823,0,1622,792,818,0,1610
14,JALISCO,10,ZAPOPAN,120,ZAPOPAN,2904,625,648,0,1273,622,642,0,1264
14,JALISCO,10,ZAPOPAN,120,ZAPOPAN,2905,761,796,0,1557,758,788,0,1546
14,JALISCO,10,ZAPOPAN,120,ZAPOPAN,3050,684,714,0,1398,674,707,0,1381
14,JALISCO,10,ZAPOPAN,120,ZAPOPAN,3051,563,592,0,1155,557,583,0,1140
14,JALISCO,10,ZAPOPAN,120,ZAPOPAN,3052,849,881,0,1730,842,872,0,1714
14,JALISCO,10,ZAPOPAN,120,ZAPOPAN,3053,1019,1091,0,2110,1006,1078,0,2084
14,JALISCO,10,ZAPOPAN,120,ZAPOPAN,3054,664,760,0,1424,658,753,0,1411
14,JALISCO,10,ZAPOPAN,120,ZAPOPAN,3055,578,618,0,1196,573,614,0,1187
14,JALISCO,10,ZAPOPAN,120,ZAPOPAN,3056,641,682,0,1323,638,676,0,1314
14,JALISCO,10,ZAPOPAN,120,ZAPOPAN,3057,489,526,0,1015,486,523,0,1009
14,JALISCO,10,ZAPOPAN,120,ZAPOPAN,3058,803,825,0,1628,798,820,0,1618
14,JALISCO,10,ZAPOPAN,120,ZAPOPAN,3067,1380,1731,0,3111,1370,1718,0,3088
14,JALISCO,10,ZAPOPAN,120,ZAPOPAN,3068,3519,4078,0,7597,3493,4050,0,7543
14,JALISCO,10,ZAPOPAN,120,ZAPOPAN,3069,1082,1231,0,2313,1079,1226,0,2305
14,JALISCO,10,ZAPOPAN,120,ZAPOPAN,3070,561,552,0,1113,556,546,0,1102
14,JALISCO,10,ZAPOPAN,120,ZAPOPAN,3071,883,1011,0,1894,876,1006,0,1882
14,JALISCO,10,ZAPOPAN,120,ZAPOPAN,3072,516,609,0,1125,509,605,0,1114
14,JALISCO,10,ZAPOPAN,120,ZAPOPAN,3074,1194,1338,0,2532,1181,1327,0,2508
14,JALISCO,10,ZAPOPAN,120,ZAPOPAN,3077,1175,1325,0,2500,1165,1317,0,2482
14,JALISCO,10,ZAPOPAN,120,ZAPOPAN,3078,911,1105,0,2016,905,1097,0,2002
14,JALISCO,10,ZAPOPAN,120,ZAPOPAN,3079,1497,1612,0,3109,1483,1599,0,3082
14,JALISCO,10,ZAPOPAN,120,ZAPOPAN,3080,1286,1602,1,2889,1275,1591,1,2867
14,JALISCO,10,ZAPOPAN,120,ZAPOPAN,3081,958,1032,0,1990,953,1023,0,1976
14,JALISCO,10,ZAPOPAN,120,ZAPOPAN,3082,920,1135,0,2055,910,1122,0,2032
14,JALISCO,10,ZAPOPAN,120,ZAPOPAN,3083,941,1185,0,2126,933,1178,0,2111
14,JALISCO,10,ZAPOPAN,120,ZAPOPAN,3084,630,841,0,1471,623,835,0,1458
14,JALISCO,10,ZAPOPAN,120,ZAPOPAN,3085,762,831,0,1593,752,830,0,1582
14,JALISCO,10,ZAPOPAN,120,ZAPOPAN,3088,613,766,0,1379,608,759,0,1367
14,JALISCO,10,ZAPOPAN,120,ZAPOPAN,3089,448,489,0,937,442,485,0,927
14,JALISCO,10,ZAPOPAN,120,ZAPOPAN,3090,735,871,0,1606,725,865,0,1590
14,JALISCO,10,ZAPOPAN,120,ZAPOPAN,3091,797,940,0,1737,790,931,0,1721
14,JALISCO,10,ZAPOPAN,120,ZAPOPAN,3092,767,862,0,1629,763,854,0,1617
14,JALISCO,10,ZAPOPAN,120,ZAPOPAN,3093,741,828,0,1569,736,823,0,1559
14,JALISCO,10,ZAPOPAN,120,ZAPOPAN,3094,838,998,0,1836,833,993,0,1826
14,JALISCO,10,ZAPOPAN,120,ZAPOPAN,3095,969,1033,0,2002,959,1027,0,1986
14,JALISCO,10,ZAPOPAN,120,ZAPOPAN,3096,703,696,0,1399,697,692,0,1389
14,JALISCO,10,ZAPOPAN,120,ZAPOPAN,3097,1768,1864,0,3632,1758,1849,0,3607
14,JALISCO,10,ZAPOPAN,120,ZAPOPAN,3098,1009,1030,0,2039,993,1021,0,2014
14,JALISCO,10,ZAPOPAN,120,ZAPOPAN,3100,1497,1686,0,3183,1487,1673,0,3160
14,JALISCO,10,ZAPOPAN,120,ZAPOPAN,3101,910,1014,0,1924,902,1007,0,1909
14,JALISCO,10,ZAPOPAN,120,ZAPOPAN,3102,626,707,1,1334,620,701,1,1322
14,JALISCO,10,ZAPOPAN,120,ZAPOPAN,3103,1197,1394,0,2591,1189,1383,0,2572
14,JALISCO,10,ZAPOPAN,120,ZAPOPAN,3104,911,1010,0,1921,903,1002,0,1905
14,JALISCO,10,ZAPOPAN,120,ZAPOPAN,3105,1279,1430,0,2709,1268,1418,0,2686
14,JALISCO,10,ZAPOPAN,120,ZAPOPAN,3106,937,1117,0,2054,935,1106,0,2041
14,JALISCO,10,ZAPOPAN,120,ZAPOPAN,3107,733,879,0,1612,726,876,0,1602
14,JALISCO,10,ZAPOPAN,120,ZAPOPAN,3108,665,751,0,1416,658,741,0,1399
14,JALISCO,10,ZAPOPAN,120,ZAPOPAN,3109,441,565,0,1006,440,559,0,999
14,JALISCO,10,ZAPOPAN,120,ZAPOPAN,3110,995,1176,0,2171,988,1168,0,2156
14,JALISCO,10,ZAPOPAN,120,ZAPOPAN,3111,3922,4363,0,8285,3898,4335,0,8233
14,JALISCO,10,ZAPOPAN,120,ZAPOPAN,3112,1574,1861,0,3435,1564,1852,0,3416
14,JALISCO,10,ZAPOPAN,120,ZAPOPAN,3113,1989,2390,0,4379,1975,2373,0,4348
14,JALISCO,10,ZAPOPAN,120,ZAPOPAN,3114,3661,4237,0,7898,3634,4200,0,7834
14,JALISCO,10,ZAPOPAN,120,ZAPOPAN,3115,918,1072,0,1990,910,1065,0,1975
14,JALISCO,10,ZAPOPAN,120,ZAPOPAN,3120,2345,2426,0,4771,2325,2408,0,4733
14,JALISCO,10,ZAPOPAN,120,ZAPOPAN,3121,2579,2646,0,5225,2560,2632,0,5192
14,JALISCO,10,ZAPOPAN,120,ZAPOPAN,3122,2909,2957,0,5866,2889,2936,0,5825
14,JALISCO,10,ZAPOPAN,120,ZAPOPAN,3123,665,776,0,1441,661,766,0,1427
14,JALISCO,10,ZAPOPAN,120,ZAPOPAN,3124,939,970,0,1909,928,961,0,1889
14,JALISCO,10,ZAPOPAN,120,ZAPOPAN,3125,865,1023,0,1888,860,1018,0,1878
14,JALISCO,10,ZAPOPAN,120,ZAPOPAN,3126,2389,2884,0,5273,2369,2862,0,5231
14,JALISCO,10,ZAPOPAN,120,ZAPOPAN,3127,538,652,0,1190,536,650,0,1186
14,JALISCO,10,ZAPOPAN,120,ZAPOPAN,3128,594,655,0,1249,590,647,0,1237
14,JALISCO,10,ZAPOPAN,120,ZAPOPAN,3129,1348,1518,0,2866,1330,1510,0,2840
14,JALISCO,10,ZAPOPAN,120,ZAPOPAN,3130,967,1069,0,2036,958,1061,0,2019
14,JALISCO,10,ZAPOPAN,120,ZAPOPAN,3131,690,756,0,1446,688,747,0,1435
14,JALISCO,10,ZAPOPAN,120,ZAPOPAN,3132,1789,2042,0,3831,1777,2031,0,3808
14,JALISCO,10,ZAPOPAN,120,ZAPOPAN,3133,1049,1197,0,2246,1040,1181,0,2221
14,JALISCO,10,ZAPOPAN,120,ZAPOPAN,3134,574,648,0,1222,569,643,0,1212
14,JALISCO,10,ZAPOPAN,120,ZAPOPAN,3135,631,736,0,1367,622,729,0,1351
14,JALISCO,10,ZAPOPAN,120,ZAPOPAN,3136,537,597,0,1134,534,592,0,1126
14,JALISCO,10,ZAPOPAN,120,ZAPOPAN,3137,640,734,0,1374,629,723,0,1352
14,JALISCO,10,ZAPOPAN,120,ZAPOPAN,3138,562,634,0,1196,558,629,0,1187
14,JALISCO,10,ZAPOPAN,120,ZAPOPAN,3139,594,688,0,1282,593,683,0,1276
14,JALISCO,10,ZAPOPAN,120,ZAPOPAN,3140,555,706,0,1261,549,697,0,1246
14,JALISCO,10,ZAPOPAN,120,ZAPOPAN,3141,552,688,0,1240,548,684,0,1232
14,JALISCO,10,ZAPOPAN,120,ZAPOPAN,3142,466,529,0,995,463,522,0,985
14,JALISCO,10,ZAPOPAN,120,ZAPOPAN,3143,664,685,0,1349,659,684,0,1343
14,JALISCO,10,ZAPOPAN,120,ZAPOPAN,3144,822,890,0,1712,811,887,0,1698
14,JALISCO,10,ZAPOPAN,120,ZAPOPAN,3145,924,1139,0,2063,911,1135,0,2046
14,JALISCO,10,ZAPOPAN,120,ZAPOPAN,3146,644,688,0,1332,640,681,0,1321
14,JALISCO,10,ZAPOPAN,120,ZAPOPAN,3147,2393,2617,0,5010,2368,2596,0,4964
14,JALISCO,10,ZAPOPAN,120,ZAPOPAN,3148,1246,1283,0,2529,1233,1274,0,2507
14,JALISCO,10,ZAPOPAN,120,ZAPOPAN,3149,1048,1220,0,2268,1038,1212,0,2250
14,JALISCO,10,ZAPOPAN,120,ZAPOPAN,3150,1066,1084,0,2150,1058,1075,0,2133
14,JALISCO,10,ZAPOPAN,120,ZAPOPAN,3151,2003,2128,0,4131,1985,2104,0,4089
14,JALISCO,10,ZAPOPAN,120,ZAPOPAN,3155,2588,2645,0,5233,2571,2616,0,5187
14,JALISCO,10,ZAPOPAN,120,ZAPOPAN,3156,1887,2006,0,3893,1874,1995,0,3869
14,JALISCO,10,ZAPOPAN,120,ZAPOPAN,3157,2752,2864,0,5616,2732,2845,0,5577
14,JALISCO,10,ZAPOPAN,120,ZAPOPAN,3158,2534,2567,0,5101,2512,2549,0,5061
14,JALISCO,10,ZAPOPAN,120,ZAPOPAN,3159,2075,2196,0,4271,2064,2177,0,4241
14,JALISCO,10,ZAPOPAN,120,ZAPOPAN,3160,1735,1837,0,3572,1725,1828,0,3553
14,JALISCO,10,ZAPOPAN,120,ZAPOPAN,3161,1369,1698,0,3067,1362,1682,0,3044
14,JALISCO,10,ZAPOPAN,120,ZAPOPAN,3162,911,1003,0,1914,905,996,0,1901
14,JALISCO,10,ZAPOPAN,120,ZAPOPAN,3163,925,1052,0,1977,919,1046,0,1965
14,JALISCO,10,ZAPOPAN,120,ZAPOPAN,3164,481,560,0,1041,479,553,0,1032
14,JALISCO,10,ZAPOPAN,120,ZAPOPAN,3165,350,454,0,804,348,448,0,796
14,JALISCO,10,ZAPOPAN,120,ZAPOPAN,3166,711,727,0,1438,705,726,0,1431
14,JALISCO,10,ZAPOPAN,120,ZAPOPAN,3167,895,992,0,1887,890,985,0,1875
14,JALISCO,10,ZAPOPAN,120,ZAPOPAN,3168,1457,1624,0,3081,1450,1613,0,3063
14,JALISCO,10,ZAPOPAN,120,ZAPOPAN,3169,563,575,0,1138,557,571,0,1128
14,JALISCO,10,ZAPOPAN,120,ZAPOPAN,3170,887,1063,0,1950,876,1057,0,1933
14,JALISCO,10,ZAPOPAN,120,ZAPOPAN,3171,565,649,0,1214,559,648,0,1207
14,JALISCO,10,ZAPOPAN,120,ZAPOPAN,3173,1134,1202,0,2336,1132,1194,0,2326
14,JALISCO,10,ZAPOPAN,120,ZAPOPAN,3174,868,879,0,1747,859,874,0,1733
14,JALISCO,10,ZAPOPAN,120,ZAPOPAN,3175,875,970,0,1845,865,963,0,1828
14,JALISCO,10,ZAPOPAN,120,ZAPOPAN,3176,791,875,0,1666,786,864,0,1650
14,JALISCO,10,ZAPOPAN,120,ZAPOPAN,3177,732,840,0,1572,724,830,0,1554
14,JALISCO,10,ZAPOPAN,120,ZAPOPAN,3178,641,707,0,1348,638,705,0,1343
14,JALISCO,10,ZAPOPAN,120,ZAPOPAN,3179,708,830,0,1538,698,821,0,1519
14,JALISCO,10,ZAPOPAN,120,ZAPOPAN,3180,682,819,0,1501,678,811,0,1489
14,JALISCO,10,ZAPOPAN,120,ZAPOPAN,3181,570,656,0,1226,569,650,0,1219
14,JALISCO,10,ZAPOPAN,120,ZAPOPAN,3182,562,605,0,1167,557,601,0,1158
14,JALISCO,10,ZAPOPAN,120,ZAPOPAN,3183,520,611,0,1131,513,602,0,1115
14,JALISCO,10,ZAPOPAN,120,ZAPOPAN,3184,446,562,0,1008,441,558,0,999
14,JALISCO,10,ZAPOPAN,120,ZAPOPAN,3185,584,651,0,1235,578,643,0,1221
14,JALISCO,10,ZAPOPAN,120,ZAPOPAN,3186,737,835,0,1572,734,828,0,1562
14,JALISCO,10,ZAPOPAN,120,ZAPOPAN,3187,1176,1360,0,2536,1166,1349,0,2515
14,JALISCO,10,ZAPOPAN,120,ZAPOPAN,3188,887,1054,0,1941,883,1046,0,1929
14,JALISCO,10,ZAPOPAN,120,ZAPOPAN,3189,702,841,0,1543,700,834,0,1534
14,JALISCO,10,ZAPOPAN,120,ZAPOPAN,3190,654,739,0,1393,652,728,0,1380
14,JALISCO,10,ZAPOPAN,120,ZAPOPAN,3191,485,520,0,1005,482,519,0,1001
14,JALISCO,10,ZAPOPAN,120,ZAPOPAN,3192,564,634,0,1198,560,630,0,1190
14,JALISCO,10,ZAPOPAN,120,ZAPOPAN,3193,452,497,0,949,444,496,0,940
14,JALISCO,10,ZAPOPAN,120,ZAPOPAN,3194,643,790,0,1433,639,784,0,1423
14,JALISCO,10,ZAPOPAN,120,ZAPOPAN,3195,689,787,0,1476,685,782,0,1467
14,JALISCO,10,ZAPOPAN,120,ZAPOPAN,3196,697,799,0,1496,693,791,0,1484
14,JALISCO,10,ZAPOPAN,120,ZAPOPAN,3197,793,845,1,1639,789,842,1,1632
14,JALISCO,10,ZAPOPAN,120,ZAPOPAN,3198,960,1045,0,2005,957,1034,0,1991
14,JALISCO,10,ZAPOPAN,120,ZAPOPAN,3200,454,529,0,983,447,525,0,972
14,JALISCO,10,ZAPOPAN,120,ZAPOPAN,3205,588,720,0,1308,582,715,0,1297
14,JALISCO,10,ZAPOPAN,120,ZAPOPAN,3210,1496,1516,0,3012,1486,1501,0,2987
14,JALISCO,10,ZAPOPAN,120,ZAPOPAN,3211,1614,1638,0,3252,1604,1628,0,3232
14,JALISCO,10,ZAPOPAN,120,ZAPOPAN,3212,1649,1787,0,3436,1638,1773,0,3411
14,JALISCO,10,ZAPOPAN,120,ZAPOPAN,3213,2655,2749,0,5404,2626,2727,0,5353
14,JALISCO,10,ZAPOPAN,120,ZAPOPAN,3531,575,630,0,1205,569,624,0,1193
14,JALISCO,10,ZAPOPAN,120,ZAPOPAN,3533,610,626,0,1236,607,622,0,1229
14,JALISCO,10,ZAPOPAN,120,ZAPOPAN,3537,495,483,0,978,490,476,0,966
14,JALISCO,10,ZAPOPAN,120,ZAPOPAN,3538,510,540,0,1050,504,537,0,1041
14,JALISCO,10,ZAPOPAN,120,ZAPOPAN,3542,560,565,0,1125,557,558,0,1115
14,JALISCO,10,ZAPOPAN,120,ZAPOPAN,3543,487,525,0,1012,483,517,0,1000
14,JALISCO,10,ZAPOPAN,120,ZAPOPAN,3544,545,505,0,1050,540,504,0,1044
14,JALISCO,10,ZAPOPAN,120,ZAPOPAN,3652,1081,1212,0,2293,1076,1201,0,2277
14,JALISCO,10,ZAPOPAN,120,ZAPOPAN,3653,1038,999,0,2037,1026,990,0,2016
14,JALISCO,10,ZAPOPAN,120,ZAPOPAN,3721,1072,1374,0,2446,1068,1357,0,2425
14,JALISCO,10,ZAPOPAN,120,ZAPOPAN,3722,741,977,0,1718,729,968,0,1697
14,JALISCO,10,ZAPOPAN,120,ZAPOPAN,3723,1178,1396,0,2574,1167,1387,0,2554
14,JALISCO,10,ZAPOPAN,120,ZAPOPAN,3724,988,1205,0,2193,975,1198,0,2173
14,JALISCO,10,ZAPOPAN,120,ZAPOPAN,3725,921,1072,0,1993,910,1066,0,1976
14,JALISCO,10,ZAPOPAN,120,ZAPOPAN,3726,756,798,0,1554,747,790,0,1537
14,JALISCO,10,ZAPOPAN,120,ZAPOPAN,3727,1552,1671,0,3223,1534,1657,0,3191
14,JALISCO,10,ZAPOPAN,120,ZAPOPAN,3728,949,1018,0,1967,934,1009,0,1943
14,JALISCO,10,ZAPOPAN,120,ZAPOPAN,3729,955,958,0,1913,944,946,0,1890
14,JALISCO,10,ZAPOPAN,120,ZAPOPAN,3730,957,940,0,1897,949,932,0,1881
14,JALISCO,10,ZAPOPAN,120,ZAPOPAN,3731,1089,1131,0,2220,1081,1125,0,2206
14,JALISCO,10,ZAPOPAN,120,ZAPOPAN,3807,529,613,0,1142,522,606,0,1128
14,JALISCO,10,ZAPOPAN,120,ZAPOPAN,3808,1125,1308,0,2433,1108,1296,0,2404
14,JALISCO,10,ZAPOPAN,120,ZAPOPAN,3809,1448,1487,0,2935,1437,1477,0,2914
14,JALISCO,10,ZAPOPAN,120,ZAPOPAN,3810,1262,1422,0,2684,1254,1415,0,2669
14,JALISCO,11,GUADALAJARA,41,GUADALAJARA,665,1283,1418,0,2701,1272,1408,0,2680
14,JALISCO,11,GUADALAJARA,41,GUADALAJARA,666,954,1053,0,2007,943,1039,0,1982
14,JALISCO,11,GUADALAJARA,41,GUADALAJARA,667,677,722,0,1399,667,717,0,1384
14,JALISCO,11,GUADALAJARA,41,GUADALAJARA,668,550,608,0,1158,547,604,0,1151
14,JALISCO,11,GUADALAJARA,41,GUADALAJARA,669,778,852,0,1630,767,846,0,1613
14,JALISCO,11,GUADALAJARA,41,GUADALAJARA,670,439,483,0,922,439,480,0,919
14,JALISCO,11,GUADALAJARA,41,GUADALAJARA,671,449,471,0,920,445,468,0,913
14,JALISCO,11,GUADALAJARA,41,GUADALAJARA,672,630,689,0,1319,628,684,0,1312
14,JALISCO,11,GUADALAJARA,41,GUADALAJARA,673,603,673,0,1276,599,662,0,1261
14,JALISCO,11,GUADALAJARA,41,GUADALAJARA,674,831,845,0,1676,825,838,0,1663
14,JALISCO,11,GUADALAJARA,41,GUADALAJARA,675,595,694,0,1289,588,683,0,1271
14,JALISCO,11,GUADALAJARA,41,GUADALAJARA,676,513,530,0,1043,505,529,0,1034
14,JALISCO,11,GUADALAJARA,41,GUADALAJARA,677,600,580,1,1181,593,571,1,1165
14,JALISCO,11,GUADALAJARA,41,GUADALAJARA,678,512,577,0,1089,506,574,0,1080
14,JALISCO,11,GUADALAJARA,41,GUADALAJARA,679,644,701,0,1345,636,698,0,1334
14,JALISCO,11,GUADALAJARA,41,GUADALAJARA,680,607,642,0,1249,604,640,0,1244
14,JALISCO,11,GUADALAJARA,41,GUADALAJARA,681,511,519,0,1030,509,515,0,1024
14,JALISCO,11,GUADALAJARA,41,GUADALAJARA,682,504,516,0,1020,496,514,0,1010
14,JALISCO,11,GUADALAJARA,41,GUADALAJARA,683,660,730,0,1390,653,722,0,1375
14,JALISCO,11,GUADALAJARA,41,GUADALAJARA,684,706,749,0,1455,702,744,0,1446
14,JALISCO,11,GUADALAJARA,41,GUADALAJARA,685,677,797,0,1474,673,796,0,1469
14,JALISCO,11,GUADALAJARA,41,GUADALAJARA,686,556,567,0,1123,549,560,0,1109
14,JALISCO,11,GUADALAJARA,41,GUADALAJARA,687,581,607,0,1188,581,602,0,1183
14,JALISCO,11,GUADALAJARA,41,GUADALAJARA,688,553,590,0,1143,545,586,0,1131
14,JALISCO,11,GUADALAJARA,41,GUADALAJARA,689,352,367,0,719,351,366,0,717
14,JALISCO,11,GUADALAJARA,41,GUADALAJARA,690,515,593,0,1108,508,590,0,1098
14,JALISCO,11,GUADALAJARA,41,GUADALAJARA,691,590,701,0,1291,585,696,0,1281
14,JALISCO,11,GUADALAJARA,41,GUADALAJARA,692,644,743,0,1387,635,734,0,1369
14,JALISCO,11,GUADALAJARA,41,GUADALAJARA,693,541,555,0,1096,534,549,0,1083
14,JALISCO,11,GUADALAJARA,41,GUADALAJARA,694,554,562,0,1116,549,558,0,1107
14,JALISCO,11,GUADALAJARA,41,GUADALAJARA,695,682,746,0,1428,677,737,0,1414
14,JALISCO,11,GUADALAJARA,41,GUADALAJARA,696,773,900,0,1673,763,890,0,1653
14,JALISCO,11,GUADALAJARA,41,GUADALAJARA,697,642,702,0,1344,635,697,0,1332
14,JALISCO,11,GUADALAJARA,41,GUADALAJARA,698,554,606,0,1160,547,600,0,1147
14,JALISCO,11,GUADALAJARA,41,GUADALAJARA,699,738,729,0,1467,732,723,0,1455
14,JALISCO,11,GUADALAJARA,41,GUADALAJARA,700,641,634,0,1275,638,627,0,1265
14,JALISCO,11,GUADALAJARA,41,GUADALAJARA,701,762,884,0,1646,758,872,0,1630
14,JALISCO,11,GUADALAJARA,41,GUADALAJARA,702,627,657,0,1284,619,653,0,1272
14,JALISCO,11,GUADALAJARA,41,GUADALAJARA,703,539,632,0,1171,537,629,0,1166
14,JALISCO,11,GUADALAJARA,41,GUADALAJARA,704,789,810,0,1599,778,801,0,1579
14,JALISCO,11,GUADALAJARA,41,GUADALAJARA,705,621,655,0,1276,612,646,0,1258
14,JALISCO,11,GUADALAJARA,41,GUADALAJARA,706,1000,1039,0,2039,991,1032,0,2023
14,JALISCO,11,GUADALAJARA,41,GUADALAJARA,707,440,498,0,938,437,496,0,933
14,JALISCO,11,GUADALAJARA,41,GUADALAJARA,721,631,598,0,1229,622,592,0,1214
14,JALISCO,11,GUADALAJARA,41,GUADALAJARA,722,553,595,0,1148,550,594,0,1144
14,JALISCO,11,GUADALAJARA,41,GUADALAJARA,723,770,833,0,1603,764,823,0,1587
14,JALISCO,11,GUADALAJARA,41,GUADALAJARA,724,839,891,0,1730,830,884,0,1714
14,JALISCO,11,GUADALAJARA,41,GUADALAJARA,725,761,809,0,1570,756,808,0,1564
14,JALISCO,11,GUADALAJARA,41,GUADALAJARA,726,681,713,0,1394,671,711,0,1382
14,JALISCO,11,GUADALAJARA,41,GUADALAJARA,727,798,887,0,1685,789,880,0,1669
14,JALISCO,11,GUADALAJARA,41,GUADALAJARA,728,737,783,0,1520,731,778,0,1509
14,JALISCO,11,GUADALAJARA,41,GUADALAJARA,729,579,635,0,1214,574,633,0,1207
14,JALISCO,11,GUADALAJARA,41,GUADALAJARA,730,923,982,0,1905,915,971,0,1886
14,JALISCO,11,GUADALAJARA,41,GUADALAJARA,731,695,745,0,1440,687,741,0,1428
14,JALISCO,11,GUADALAJARA,41,GUADALAJARA,732,410,440,0,850,407,438,0,845
14,JALISCO,11,GUADALAJARA,41,GUADALAJARA,733,346,340,0,686,345,338,0,683
14,JALISCO,11,GUADALAJARA,41,GUADALAJARA,734,489,541,0,1030,483,536,0,1019
14,JALISCO,11,GUADALAJARA,41,GUADALAJARA,735,450,464,0,914,444,462,0,906
14,JALISCO,11,GUADALAJARA,41,GUADALAJARA,736,808,815,0,1623,803,804,0,1607
14,JALISCO,11,GUADALAJARA,41,GUADALAJARA,737,350,344,0,694,348,341,0,689
14,JALISCO,11,GUADALAJARA,41,GUADALAJARA,738,426,447,0,873,419,441,0,860
14,JALISCO,11,GUADALAJARA,41,GUADALAJARA,739,594,597,0,1191,590,589,0,1179
14,JALISCO,11,GUADALAJARA,41,GUADALAJARA,740,427,440,0,867,422,436,0,858
14,JALISCO,11,GUADALAJARA,41,GUADALAJARA,741,545,561,0,1106,538,554,0,1092
14,JALISCO,11,GUADALAJARA,41,GUADALAJARA,742,397,387,0,784,395,384,0,779
14,JALISCO,11,GUADALAJARA,41,GUADALAJARA,743,533,534,0,1067,528,532,0,1060
14,JALISCO,11,GUADALAJARA,41,GUADALAJARA,744,556,619,0,1175,552,612,0,1164
14,JALISCO,11,GUADALAJARA,41,GUADALAJARA,745,435,477,0,912,431,471,0,902
14,JALISCO,11,GUADALAJARA,41,GUADALAJARA,746,328,366,0,694,325,361,0,686
14,JALISCO,11,GUADALAJARA,41,GUADALAJARA,747,336,427,0,763,332,423,0,755
14,JALISCO,11,GUADALAJARA,41,GUADALAJARA,748,798,874,0,1672,787,868,0,1655
14,JALISCO,11,GUADALAJARA,41,GUADALAJARA,749,671,706,0,1377,666,703,0,1369
14,JALISCO,11,GUADALAJARA,41,GUADALAJARA,750,789,807,0,1596,779,800,0,1579
14,JALISCO,11,GUADALAJARA,41,GUADALAJARA,751,759,844,0,1603,755,839,0,1594
14,JALISCO,11,GUADALAJARA,41,GUADALAJARA,752,580,662,0,1242,578,654,0,1232
14,JALISCO,11,GUADALAJARA,41,GUADALAJARA,753,471,471,0,942,468,468,0,936
14,JALISCO,11,GUADALAJARA,41,GUADALAJARA,754,374,406,0,780,372,400,0,772
14,JALISCO,11,GUADALAJARA,41,GUADALAJARA,755,498,552,0,1050,493,548,0,1041
14,JALISCO,11,GUADALAJARA,41,GUADALAJARA,756,684,810,0,1494,681,800,0,1481
14,JALISCO,11,GUADALAJARA,41,GUADALAJARA,929,342,324,0,666,339,321,0,660
14,JALISCO,11,GUADALAJARA,41,GUADALAJARA,930,131,155,0,286,131,154,0,285
14,JALISCO,11,GUADALAJARA,41,GUADALAJARA,931,297,286,0,583,294,284,0,578
14,JALISCO,11,GUADALAJARA,41,GUADALAJARA,932,421,444,0,865,418,438,0,856
14,JALISCO,11,GUADALAJARA,41,GUADALAJARA,933,361,322,0,683,358,319,0,677
14,JALISCO,11,GUADALAJARA,41,GUADALAJARA,935,435,509,0,944,431,506,0,937
14,JALISCO,11,GUADALAJARA,41,GUADALAJARA,936,420,519,0,939,417,513,0,930
14,JALISCO,11,GUADALAJARA,41,GUADALAJARA,937,452,558,0,1010,447,554,0,1001
14,JALISCO,11,GUADALAJARA,41,GUADALAJARA,938,403,454,0,857,397,450,0,847
14,JALISCO,11,GUADALAJARA,41,GUADALAJARA,939,417,435,0,852,414,430,0,844
14,JALISCO,11,GUADALAJARA,41,GUADALAJARA,940,523,521,0,1044,520,513,0,1033
14,JALISCO,11,GUADALAJARA,41,GUADALAJARA,941,571,624,0,1195,565,618,0,1183
14,JALISCO,11,GUADALAJARA,41,GUADALAJARA,942,514,575,0,1089,509,571,0,1080
14,JALISCO,11,GUADALAJARA,41,GUADALAJARA,943,356,325,0,681,353,320,0,673
14,JALISCO,11,GUADALAJARA,41,GUADALAJARA,944,296,309,0,605,294,304,0,598
14,JALISCO,11,GUADALAJARA,41,GUADALAJARA,945,450,470,0,920,448,467,0,915
14,JALISCO,11,GUADALAJARA,41,GUADALAJARA,946,317,366,0,683,315,365,0,680
14,JALISCO,11,GUADALAJARA,41,GUADALAJARA,947,308,329,0,637,299,325,0,624
14,JALISCO,11,GUADALAJARA,41,GUADALAJARA,948,199,222,0,421,196,220,0,416
14,JALISCO,11,GUADALAJARA,41,GUADALAJARA,949,427,436,0,863,420,434,0,854
14,JALISCO,11,GUADALAJARA,41,GUADALAJARA,950,500,538,0,1038,496,534,0,1030
14,JALISCO,11,GUADALAJARA,41,GUADALAJARA,951,304,298,0,602,301,298,0,599
14,JALISCO,11,GUADALAJARA,41,GUADALAJARA,952,306,351,0,657,300,345,0,645
14,JALISCO,11,GUADALAJARA,41,GUADALAJARA,953,315,377,0,692,311,374,0,685
14,JALISCO,11,GUADALAJARA,41,GUADALAJARA,954,359,423,0,782,357,420,0,777
14,JALISCO,11,GUADALAJARA,41,GUADALAJARA,955,356,421,0,777,352,416,0,768
14,JALISCO,11,GUADALAJARA,41,GUADALAJARA,956,339,402,0,741,337,400,0,737
14,JALISCO,11,GUADALAJARA,41,GUADALAJARA,957,362,403,0,765,361,398,0,759
14,JALISCO,11,GUADALAJARA,41,GUADALAJARA,958,597,645,0,1242,589,642,0,1231
14,JALISCO,11,GUADALAJARA,41,GUADALAJARA,959,367,413,0,780,364,409,0,773
14,JALISCO,11,GUADALAJARA,41,GUADALAJARA,960,399,364,0,763,392,362,0,754
14,JALISCO,11,GUADALAJARA,41,GUADALAJARA,961,366,371,0,737,363,370,0,733
14,JALISCO,11,GUADALAJARA,41,GUADALAJARA,962,374,394,0,768,365,388,0,753
14,JALISCO,11,GUADALAJARA,41,GUADALAJARA,963,372,372,0,744,368,370,0,738
14,JALISCO,11,GUADALAJARA,41,GUADALAJARA,964,544,655,0,1199,540,652,0,1192
14,JALISCO,11,GUADALAJARA,41,GUADALAJARA,965,338,405,0,743,338,402,0,740
14,JALISCO,11,GUADALAJARA,41,GUADALAJARA,966,365,425,0,790,363,419,0,782
14,JALISCO,11,GUADALAJARA,41,GUADALAJARA,975,440,527,0,967,438,521,0,959
14,JALISCO,11,GUADALAJARA,41,GUADALAJARA,976,272,310,0,582,271,306,0,577
14,JALISCO,11,GUADALAJARA,41,GUADALAJARA,1009,344,373,0,717,339,372,0,711
14,JALISCO,11,GUADALAJARA,41,GUADALAJARA,1010,361,390,0,751,360,386,0,746
14,JALISCO,11,GUADALAJARA,41,GUADALAJARA,1011,586,664,0,1250,579,656,0,1235
14,JALISCO,11,GUADALAJARA,41,GUADALAJARA,1012,577,603,0,1180,572,598,0,1170
14,JALISCO,11,GUADALAJARA,41,GUADALAJARA,1013,415,501,0,916,414,497,0,911
14,JALISCO,11,GUADALAJARA,41,GUADALAJARA,1014,578,642,0,1220,572,640,0,1212
14,JALISCO,11,GUADALAJARA,41,GUADALAJARA,1015,441,413,0,854,435,408,0,843
14,JALISCO,11,GUADALAJARA,41,GUADALAJARA,1016,411,463,0,874,408,459,0,867
14,JALISCO,11,GUADALAJARA,41,GUADALAJARA,1017,458,489,0,947,449,486,0,935
14,JALISCO,11,GUADALAJARA,41,GUADALAJARA,1018,320,333,0,653,319,330,0,649
14,JALISCO,11,GUADALAJARA,41,GUADALAJARA,1019,623,584,0,1207,615,581,0,1196
14,JALISCO,11,GUADALAJARA,41,GUADALAJARA,1020,289,324,0,613,286,324,0,610
14,JALISCO,11,GUADALAJARA,41,GUADALAJARA,1021,443,512,0,955,434,505,0,939
14,JALISCO,11,GUADALAJARA,41,GUADALAJARA,1022,304,387,0,691,298,385,0,683
14,JALISCO,11,GUADALAJARA,41,GUADALAJARA,1023,330,360,0,690,326,355,0,681
14,JALISCO,11,GUADALAJARA,41,GUADALAJARA,1024,348,372,0,720,345,371,0,716
14,JALISCO,11,GUADALAJARA,41,GUADALAJARA,1025,323,377,0,700,321,377,0,698
14,JALISCO,11,GUADALAJARA,41,GUADALAJARA,1026,237,239,0,476,231,235,0,466
14,JALISCO,11,GUADALAJARA,41,GUADALAJARA,1027,425,469,0,894,421,465,0,886
14,JALISCO,11,GUADALAJARA,41,GUADALAJARA,1028,259,243,0,502,253,242,0,495
14,JALISCO,11,GUADALAJARA,41,GUADALAJARA,1029,225,225,0,450,221,222,0,443
14,JALISCO,11,GUADALAJARA,41,GUADALAJARA,1030,346,354,0,700,345,352,0,697
14,JALISCO,11,GUADALAJARA,41,GUADALAJARA,1031,331,343,0,674,330,337,0,667
14,JALISCO,11,GUADALAJARA,41,GUADALAJARA,1032,363,389,0,752,358,387,0,745
14,JALISCO,11,GUADALAJARA,41,GUADALAJARA,1033,470,570,0,1040,466,568,0,1034
14,JALISCO,11,GUADALAJARA,41,GUADALAJARA,1034,272,300,0,572,272,297,0,569
14,JALISCO,11,GUADALAJARA,41,GUADALAJARA,1035,469,522,0,991,463,519,0,982
14,JALISCO,11,GUADALAJARA,41,GUADALAJARA,1036,332,340,0,672,332,340,0,672
14,JALISCO,11,GUADALAJARA,41,GUADALAJARA,1037,363,415,0,778,359,412,0,771
14,JALISCO,11,GUADALAJARA,41,GUADALAJARA,1038,398,445,0,843,395,441,0,836
14,JALISCO,11,GUADALAJARA,41,GUADALAJARA,1039,300,325,0,625,299,322,0,621
14,JALISCO,11,GUADALAJARA,41,GUADALAJARA,1040,430,486,0,916,425,478,0,903
14,JALISCO,11,GUADALAJARA,41,GUADALAJARA,1041,384,416,0,800,379,411,0,790
14,JALISCO,11,GUADALAJARA,41,GUADALAJARA,1042,432,459,0,891,429,455,0,884
14,JALISCO,11,GUADALAJARA,41,GUADALAJARA,1043,346,366,0,712,342,360,0,702
14,JALISCO,11,GUADALAJARA,41,GUADALAJARA,1044,309,315,0,624,305,312,0,617
14,JALISCO,11,GUADALAJARA,41,GUADALAJARA,1045,129,116,0,245,129,116,0,245
14,JALISCO,11,GUADALAJARA,41,GUADALAJARA,1046,284,323,0,607,282,316,0,598
14,JALISCO,11,GUADALAJARA,41,GUADALAJARA,1047,311,296,0,607,307,294,0,601
14,JALISCO,11,GUADALAJARA,41,GUADALAJARA,1048,106,94,0,200,106,92,0,198
14,JALISCO,11,GUADALAJARA,41,GUADALAJARA,1049,165,136,0,301,162,134,0,296
14,JALISCO,11,GUADALAJARA,41,GUADALAJARA,1374,393,447,0,840,387,439,0,826
14,JALISCO,11,GUADALAJARA,41,GUADALAJARA,1375,423,478,0,901,420,474,0,894
14,JALISCO,11,GUADALAJARA,41,GUADALAJARA,1376,550,608,0,1158,547,597,0,1144
14,JALISCO,11,GUADALAJARA,41,GUADALAJARA,1377,516,540,0,1056,510,533,0,1043
14,JALISCO,11,GUADALAJARA,41,GUADALAJARA,1378,1270,1377,0,2647,1264,1364,0,2628
14,JALISCO,11,GUADALAJARA,41,GUADALAJARA,1379,767,862,0,1629,764,855,0,1619
14,JALISCO,11,GUADALAJARA,41,GUADALAJARA,1380,1398,1498,0,2896,1383,1486,0,2869
14,JALISCO,11,GUADALAJARA,41,GUADALAJARA,1381,602,635,0,1237,598,631,0,1229
14,JALISCO,11,GUADALAJARA,41,GUADALAJARA,1382,563,644,0,1207,558,637,0,1195
14,JALISCO,11,GUADALAJARA,41,GUADALAJARA,1383,697,703,0,1400,691,695,0,1386
14,JALISCO,11,GUADALAJARA,41,GUADALAJARA,1384,593,655,0,1248,590,654,0,1244
14,JALISCO,11,GUADALAJARA,41,GUADALAJARA,1385,1051,1096,0,2147,1040,1083,0,2123
14,JALISCO,11,GUADALAJARA,41,GUADALAJARA,1386,581,600,0,1181,569,595,0,1164
14,JALISCO,11,GUADALAJARA,41,GUADALAJARA,1387,1042,1072,0,2114,1034,1060,0,2094
14,JALISCO,11,GUADALAJARA,41,GUADALAJARA,1388,469,525,0,994,463,519,0,982
14,JALISCO,11,GUADALAJARA,41,GUADALAJARA,1389,989,1093,0,2082,981,1086,0,2067
14,JALISCO,11,GUADALAJARA,41,GUADALAJARA,1390,588,633,0,1221,584,625,0,1209
14,JALISCO,11,GUADALAJARA,41,GUADALAJARA,1391,565,663,0,1228,559,651,0,1210
14,JALISCO,11,GUADALAJARA,41,GUADALAJARA,1392,637,638,0,1275,629,632,0,1261
14,JALISCO,11,GUADALAJARA,41,GUADALAJARA,1393,610,679,0,1289,605,676,0,1281
14,JALISCO,11,GUADALAJARA,41,GUADALAJARA,1394,564,584,0,1148,560,580,0,1140
14,JALISCO,11,GUADALAJARA,41,GUADALAJARA,1395,713,722,0,1435,709,713,0,1422
14,JALISCO,11,GUADALAJARA,41,GUADALAJARA,1396,560,615,0,1175,556,608,0,1164
14,JALISCO,11,GUADALAJARA,41,GUADALAJARA,1397,1113,1204,0,2317,1101,1190,0,2291
14,JALISCO,11,GUADALAJARA,41,GUADALAJARA,1398,497,505,0,1002,495,501,0,996
14,JALISCO,11,GUADALAJARA,41,GUADALAJARA,1399,547,608,0,1155,540,605,0,1145
14,JALISCO,11,GUADALAJARA,41,GUADALAJARA,1400,719,745,0,1464,713,739,0,1452
14,JALISCO,11,GUADALAJARA,41,GUADALAJARA,1401,729,817,0,1546,726,814,0,1540
14,JALISCO,11,GUADALAJARA,41,GUADALAJARA,1402,704,768,0,1472,697,763,0,1460
14,JALISCO,11,GUADALAJARA,41,GUADALAJARA,1403,830,868,0,1698,824,862,0,1686
14,JALISCO,11,GUADALAJARA,41,GUADALAJARA,1404,518,515,0,1033,516,509,0,1025
14,JALISCO,11,GUADALAJARA,41,GUADALAJARA,1405,489,490,0,979,485,484,0,969
14,JALISCO,11,GUADALAJARA,41,GUADALAJARA,1406,487,538,0,1025,484,531,0,1015
14,JALISCO,11,GUADALAJARA,41,GUADALAJARA,1407,718,815,0,1533,710,810,0,1520
14,JALISCO,11,GUADALAJARA,41,GUADALAJARA,1408,672,719,0,1391,667,713,0,1380
14,JALISCO,11,GUADALAJARA,41,GUADALAJARA,1409,652,717,0,1369,641,706,0,1347
14,JALISCO,11,GUADALAJARA,41,GUADALAJARA,1410,503,561,0,1064,497,559,0,1056
14,JALISCO,11,GUADALAJARA,41,GUADALAJARA,1411,651,668,0,1319,644,662,0,1306
14,JALISCO,11,GUADALAJARA,41,GUADALAJARA,1412,685,712,0,1397,681,708,0,1389
14,JALISCO,11,GUADALAJARA,41,GUADALAJARA,1413,796,858,0,1654,792,852,0,1644
14,JALISCO,11,GUADALAJARA,41,GUADALAJARA,1414,548,602,0,1150,545,600,0,1145
14,JALISCO,11,GUADALAJARA,41,GUADALAJARA,1415,644,704,0,1348,634,700,0,1334
14,JALISCO,11,GUADALAJARA,41,GUADALAJARA,1416,889,902,0,1791,876,894,0,1770
14,JALISCO,11,GUADALAJARA,41,GUADALAJARA,1417,823,876,0,1699,814,867,0,1681
14,JALISCO,11,GUADALAJARA,41,GUADALAJARA,1418,452,523,0,975,450,522,0,972
14,JALISCO,11,GUADALAJARA,41,GUADALAJARA,1419,473,522,0,995,470,516,0,986
14,JALISCO,11,GUADALAJARA,41,GUADALAJARA,1420,515,485,0,1000,513,480,0,993
14,JALISCO,11,GUADALAJARA,41,GUADALAJARA,1421,520,571,0,1091,517,567,0,1084
14,JALISCO,11,GUADALAJARA,41,GUADALAJARA,1422,1040,1113,0,2153,1034,1100,0,2134
14,JALISCO,11,GUADALAJARA,41,GUADALAJARA,1423,553,599,0,1152,549,593,0,1142
14,JALISCO,11,GUADALAJARA,41,GUADALAJARA,1424,896,912,0,1808,891,904,0,1795
14,JALISCO,11,GUADALAJARA,41,GUADALAJARA,1425,748,778,0,1526,745,770,0,1515
14,JALISCO,11,GUADALAJARA,41,GUADALAJARA,1426,574,583,0,1157,570,579,0,1149
14,JALISCO,11,GUADALAJARA,41,GUADALAJARA,1427,730,746,0,1476,723,740,0,1463
14,JALISCO,11,GUADALAJARA,41,GUADALAJARA,1428,671,715,0,1386,667,711,0,1378
14,JALISCO,11,GUADALAJARA,41,GUADALAJARA,1429,493,506,0,999,487,504,0,991
14,JALISCO,11,GUADALAJARA,41,GUADALAJARA,1430,574,600,0,1174,566,590,0,1156
14,JALISCO,11,GUADALAJARA,41,GUADALAJARA,1431,1011,1144,0,2155,998,1137,0,2135
14,JALISCO,11,GUADALAJARA,41,GUADALAJARA,1432,538,562,0,1100,529,557,0,1086
14,JALISCO,11,GUADALAJARA,41,GUADALAJARA,1433,655,714,0,1369,651,709,0,1360
14,JALISCO,11,GUADALAJARA,41,GUADALAJARA,1434,590,635,0,1225,585,631,0,1216
14,JALISCO,11,GUADALAJARA,41,GUADALAJARA,1435,1356,1515,0,2871,1342,1507,0,2849
14,JALISCO,11,GUADALAJARA,41,GUADALAJARA,1436,1075,1202,0,2277,1069,1194,0,2263
14,JALISCO,11,GUADALAJARA,41,GUADALAJARA,1437,437,506,0,943,434,503,0,937
14,JALISCO,11,GUADALAJARA,41,GUADALAJARA,1438,383,475,0,858,380,469,0,849
14,JALISCO,11,GUADALAJARA,41,GUADALAJARA,1439,422,411,0,833,414,405,0,819
14,JALISCO,11,GUADALAJARA,41,GUADALAJARA,1440,452,490,0,942,449,488,0,937
14,JALISCO,11,GUADALAJARA,41,GUADALAJARA,1441,458,504,0,962,446,499,0,945
14,JALISCO,11,GUADALAJARA,41,GUADALAJARA,1442,448,470,0,918,446,468,0,914
14,JALISCO,11,GUADALAJARA,41,GUADALAJARA,1443,333,374,0,707,328,369,0,697
14,JALISCO,11,GUADALAJARA,41,GUADALAJARA,1444,351,363,0,714,344,363,0,707
14,JALISCO,11,GUADALAJARA,41,GUADALAJARA,1445,295,321,0,616,292,315,0,607
14,JALISCO,11,GUADALAJARA,41,GUADALAJARA,1446,417,469,0,886,411,466,0,877
14,JALISCO,11,GUADALAJARA,41,GUADALAJARA,1447,524,520,0,1044,517,516,0,1033
14,JALISCO,11,GUADALAJARA,41,GUADALAJARA,1448,856,1023,0,1879,847,1015,0,1862
14,JALISCO,11,GUADALAJARA,41,GUADALAJARA,1449,571,656,0,1227,565,652,0,1217
14,JALISCO,11,GUADALAJARA,41,GUADALAJARA,1450,861,969,0,1830,854,966,0,1820
14,JALISCO,11,GUADALAJARA,41,GUADALAJARA,1451,616,686,0,1302,609,679,0,1288
14,JALISCO,11,GUADALAJARA,41,GUADALAJARA,1452,763,838,0,1601,759,834,0,1593
14,JALISCO,11,GUADALAJARA,41,GUADALAJARA,1453,767,852,0,1619,764,844,0,1608
14,JALISCO,11,GUADALAJARA,41,GUADALAJARA,1454,890,1007,0,1897,884,1002,0,1886
14,JALISCO,11,GUADALAJARA,41,GUADALAJARA,1455,842,951,0,1793,833,949,0,1782
14,JALISCO,11,GUADALAJARA,41,GUADALAJARA,1456,904,971,0,1875,896,965,0,1861
14,JALISCO,11,GUADALAJARA,41,GUADALAJARA,1457,541,600,0,1141,536,595,0,1131
14,JALISCO,11,GUADALAJARA,41,GUADALAJARA,1458,714,772,0,1486,708,765,0,1473
14,JALISCO,11,GUADALAJARA,41,GUADALAJARA,1459,980,1051,0,2031,975,1047,0,2022
14,JALISCO,11,GUADALAJARA,41,GUADALAJARA,1460,648,625,0,1273,643,622,0,1265
14,JALISCO,11,GUADALAJARA,41,GUADALAJARA,1461,710,687,0,1397,707,682,0,1389
14,JALISCO,11,GUADALAJARA,41,GUADALAJARA,1462,585,635,0,1220,580,633,0,1213
14,JALISCO,11,GUADALAJARA,41,GUADALAJARA,1463,452,432,0,884,447,428,0,875
14,JALISCO,11,GUADALAJARA,41,GUADALAJARA,1464,575,582,0,1157,570,580,0,1150
14,JALISCO,11,GUADALAJARA,41,GUADALAJARA,1465,805,870,0,1675,796,865,0,1661
14,JALISCO,11,GUADALAJARA,41,GUADALAJARA,1466,858,888,0,1746,854,886,0,1740
14,JALISCO,11,GUADALAJARA,41,GUADALAJARA,1467,738,790,0,1528,730,781,0,1511
14,JALISCO,11,GUADALAJARA,41,GUADALAJARA,1468,671,712,0,1383,662,700,0,1362
14,JALISCO,11,GUADALAJARA,41,GUADALAJARA,1469,704,748,0,1452,694,743,0,1437
14,JALISCO,11,GUADALAJARA,41,GUADALAJARA,1470,762,774,0,1536,758,765,0,1523
14,JALISCO,11,GUADALAJARA,41,GUADALAJARA,1471,801,884,0,1685,789,877,0,1666
14,JALISCO,11,GUADALAJARA,41,GUADALAJARA,1472,713,829,0,1542,706,828,0,1534
14,JALISCO,11,GUADALAJARA,41,GUADALAJARA,1473,1006,1089,0,2095,996,1078,0,2074
14,JALISCO,11,GUADALAJARA,41,GUADALAJARA,1474,1038,1205,0,2243,1024,1196,0,2220
14,JALISCO,11,GUADALAJARA,41,GUADALAJARA,1475,763,774,0,1537,758,769,0,1527
14,JALISCO,11,GUADALAJARA,41,GUADALAJARA,1476,825,907,0,1732,821,902,0,1723
14,JALISCO,11,GUADALAJARA,41,GUADALAJARA,1477,944,982,0,1926,934,976,0,1910
14,JALISCO,11,GUADALAJARA,41,GUADALAJARA,1478,624,652,0,1276,619,649,0,1268
14,JALISCO,11,GUADALAJARA,41,GUADALAJARA,1479,755,738,0,1493,743,729,0,1472
14,JALISCO,11,GUADALAJARA,41,GUADALAJARA,1480,687,689,0,1376,685,687,0,1372
14,JALISCO,11,GUADALAJARA,41,GUADALAJARA,1481,738,842,0,1580,732,835,0,1567
14,JALISCO,11,GUADALAJARA,41,GUADALAJARA,1482,791,835,0,1626,782,824,0,1606
14,JALISCO,11,GUADALAJARA,41,GUADALAJARA,1483,872,919,0,1791,866,914,0,1780
14,JALISCO,11,GUADALAJARA,41,GUADALAJARA,1484,2746,3072,0,5818,2723,3057,0,5780
14,JALISCO,11,GUADALAJARA,41,GUADALAJARA,1485,376,429,0,805,375,425,0,800
14,JALISCO,11,GUADALAJARA,41,GUADALAJARA,1486,769,876,0,1645,763,871,0,1634
14,JALISCO,11,GUADALAJARA,41,GUADALAJARA,1487,487,522,0,1009,484,520,0,1004
14,JALISCO,11,GUADALAJARA,41,GUADALAJARA,1488,415,492,0,907,409,490,0,899
14,JALISCO,11,GUADALAJARA,41,GUADALAJARA,1489,398,440,0,838,394,434,0,828
14,JALISCO,11,GUADALAJARA,41,GUADALAJARA,1490,608,681,1,1290,604,676,1,1281
14,JALISCO,11,GUADALAJARA,41,GUADALAJARA,1491,451,488,0,939,450,485,0,935
14,JALISCO,11,GUADALAJARA,41,GUADALAJARA,1492,527,624,0,1151,521,620,0,1141
14,JALISCO,11,GUADALAJARA,41,GUADALAJARA,1493,519,577,0,1096,514,574,0,1088
14,JALISCO,11,GUADALAJARA,41,GUADALAJARA,1494,480,535,0,1015,474,534,0,1008
14,JALISCO,11,GUADALAJARA,41,GUADALAJARA,1495,539,646,0,1185,529,638,0,1167
14,JALISCO,11,GUADALAJARA,41,GUADALAJARA,1496,380,408,0,788,376,405,0,781
14,JALISCO,11,GUADALAJARA,41,GUADALAJARA,1497,561,665,0,1226,554,656,0,1210
14,JALISCO,11,GUADALAJARA,41,GUADALAJARA,1498,847,980,0,1827,835,969,0,1804
14,JALISCO,11,GUADALAJARA,41,GUADALAJARA,1499,649,785,0,1434,644,779,0,1423
14,JALISCO,11,GUADALAJARA,41,GUADALAJARA,1500,450,563,0,1013,444,556,0,1000
14,JALISCO,11,GUADALAJARA,41,GUADALAJARA,1501,499,632,0,1131,493,631,0,1124
14,JALISCO,11,GUADALAJARA,41,GUADALAJARA,1502,530,636,0,1166,523,629,0,1152
14,JALISCO,11,GUADALAJARA,41,GUADALAJARA,1503,1130,1308,0,2438,1118,1296,0,2414
14,JALISCO,11,GUADALAJARA,41,GUADALAJARA,1504,1077,1261,0,2338,1070,1252,0,2322
14,JALISCO,11,GUADALAJARA,41,GUADALAJARA,1505,764,879,0,1643,761,870,0,1631
14,JALISCO,11,GUADALAJARA,41,GUADALAJARA,1506,536,653,0,1189,535,647,0,1182
14,JALISCO,11,GUADALAJARA,41,GUADALAJARA,1507,539,690,0,1229,536,686,0,1222
14,JALISCO,11,GUADALAJARA,41,GUADALAJARA,1508,423,520,0,943,420,517,0,937
14,JALISCO,11,GUADALAJARA,41,GUADALAJARA,1509,578,669,0,1247,576,664,0,1240
14,JALISCO,11,GUADALAJARA,41,GUADALAJARA,1510,430,478,0,908,428,476,0,904
14,JALISCO,11,GUADALAJARA,41,GUADALAJARA,1511,567,640,0,1207,566,637,0,1203
14,JALISCO,11,GUADALAJARA,41,GUADALAJARA,1512,441,522,0,963,435,518,0,953
14,JALISCO,11,GUADALAJARA,41,GUADALAJARA,1513,467,529,0,996,464,527,0,991
14,JALISCO,11,GUADALAJARA,41,GUADALAJARA,1514,810,900,0,1710,801,896,0,1697
14,JALISCO,11,GUADALAJARA,41,GUADALAJARA,1515,599,701,0,1300,592,698,0,1290
14,JALISCO,11,GUADALAJARA,41,GUADALAJARA,1516,509,576,0,1085,506,573,0,1079
14,JALISCO,11,GUADALAJARA,41,GUADALAJARA,1517,838,944,0,1782,831,936,0,1767
14,JALISCO,11,GUADALAJARA,41,GUADALAJARA,1518,625,678,0,1303,621,673,0,1294
14,JALISCO,11,GUADALAJARA,41,GUADALAJARA,1519,562,609,0,1171,560,601,0,1161
14,JALISCO,11,GUADALAJARA,41,GUADALAJARA,1520,531,664,0,1195,526,655,0,1181
14,JALISCO,11,GUADALAJARA,41,GUADALAJARA,1521,564,603,0,1167,558,596,0,1154
14,JALISCO,11,GUADALAJARA,41,GUADALAJARA,1522,460,451,0,911,457,448,0,905
14,JALISCO,11,GUADALAJARA,41,GUADALAJARA,1523,494,601,0,1095,486,596,0,1082
14,JALISCO,11,GUADALAJARA,41,GUADALAJARA,1524,399,464,0,863,398,460,0,858
14,JALISCO,11,GUADALAJARA,41,GUADALAJARA,1525,502,552,0,1054,500,549,0,1049
14,JALISCO,12,TLAJOMULCO DE ZUÐIGA,98,TLAJOMULCO DE ZUÐIGA,2438,1291,1348,0,2639,1279,1336,0,2615
14,JALISCO,12,TLAJOMULCO DE ZUÐIGA,98,TLAJOMULCO DE ZUÐIGA,2439,1174,1230,0,2404,1165,1220,0,2385
14,JALISCO,12,TLAJOMULCO DE ZUÐIGA,98,TLAJOMULCO DE ZUÐIGA,2440,811,874,0,1685,805,864,0,1669
14,JALISCO,12,TLAJOMULCO DE ZUÐIGA,98,TLAJOMULCO DE ZUÐIGA,2441,601,627,0,1228,593,616,0,1209
14,JALISCO,12,TLAJOMULCO DE ZUÐIGA,98,TLAJOMULCO DE ZUÐIGA,2442,869,959,0,1828,866,954,0,1820
14,JALISCO,12,TLAJOMULCO DE ZUÐIGA,98,TLAJOMULCO DE ZUÐIGA,2446,4066,4239,0,8305,4009,4188,0,8197
14,JALISCO,12,TLAJOMULCO DE ZUÐIGA,98,TLAJOMULCO DE ZUÐIGA,2448,1460,1524,0,2984,1446,1503,0,2949
14,JALISCO,12,TLAJOMULCO DE ZUÐIGA,98,TLAJOMULCO DE ZUÐIGA,2453,4698,4944,0,9642,4665,4921,0,9586
14,JALISCO,12,TLAJOMULCO DE ZUÐIGA,98,TLAJOMULCO DE ZUÐIGA,2454,2054,2193,0,4247,2042,2183,0,4225
14,JALISCO,12,TLAJOMULCO DE ZUÐIGA,98,TLAJOMULCO DE ZUÐIGA,2456,1512,1610,0,3122,1485,1573,0,3058
14,JALISCO,12,TLAJOMULCO DE ZUÐIGA,98,TLAJOMULCO DE ZUÐIGA,2457,1030,1081,0,2111,1021,1062,0,2083
14,JALISCO,12,TLAJOMULCO DE ZUÐIGA,98,TLAJOMULCO DE ZUÐIGA,2458,1587,1629,0,3216,1568,1613,0,3181
14,JALISCO,12,TLAJOMULCO DE ZUÐIGA,98,TLAJOMULCO DE ZUÐIGA,2466,1084,1246,0,2330,1076,1233,0,2309
14,JALISCO,12,TLAJOMULCO DE ZUÐIGA,98,TLAJOMULCO DE ZUÐIGA,2470,1225,1234,0,2459,1217,1225,0,2442
14,JALISCO,12,TLAJOMULCO DE ZUÐIGA,98,TLAJOMULCO DE ZUÐIGA,3388,503,508,0,1011,501,505,0,1006
14,JALISCO,12,TLAJOMULCO DE ZUÐIGA,98,TLAJOMULCO DE ZUÐIGA,3389,1458,1562,0,3020,1441,1555,0,2996
14,JALISCO,12,TLAJOMULCO DE ZUÐIGA,98,TLAJOMULCO DE ZUÐIGA,3390,562,591,0,1153,561,586,0,1147
14,JALISCO,12,TLAJOMULCO DE ZUÐIGA,98,TLAJOMULCO DE ZUÐIGA,3391,884,870,0,1754,877,862,0,1739
14,JALISCO,12,TLAJOMULCO DE ZUÐIGA,98,TLAJOMULCO DE ZUÐIGA,3392,1794,1789,0,3583,1782,1775,0,3557
14,JALISCO,12,TLAJOMULCO DE ZUÐIGA,98,TLAJOMULCO DE ZUÐIGA,3393,1431,1504,0,2935,1422,1495,0,2917
14,JALISCO,12,TLAJOMULCO DE ZUÐIGA,98,TLAJOMULCO DE ZUÐIGA,3394,1379,1453,0,2832,1366,1447,0,2813
14,JALISCO,12,TLAJOMULCO DE ZUÐIGA,98,TLAJOMULCO DE ZUÐIGA,3395,861,927,0,1788,852,923,0,1775
14,JALISCO,12,TLAJOMULCO DE ZUÐIGA,98,TLAJOMULCO DE ZUÐIGA,3396,781,838,0,1619,775,834,0,1609
14,JALISCO,12,TLAJOMULCO DE ZUÐIGA,98,TLAJOMULCO DE ZUÐIGA,3402,705,748,0,1453,701,744,0,1445
14,JALISCO,12,TLAJOMULCO DE ZUÐIGA,98,TLAJOMULCO DE ZUÐIGA,3403,964,1059,0,2023,958,1056,0,2014
14,JALISCO,12,TLAJOMULCO DE ZUÐIGA,98,TLAJOMULCO DE ZUÐIGA,3444,851,947,0,1798,841,941,0,1782
14,JALISCO,12,TLAJOMULCO DE ZUÐIGA,98,TLAJOMULCO DE ZUÐIGA,3445,877,880,0,1757,865,874,0,1739
14,JALISCO,12,TLAJOMULCO DE ZUÐIGA,98,TLAJOMULCO DE ZUÐIGA,3446,698,709,0,1407,691,704,0,1395
14,JALISCO,12,TLAJOMULCO DE ZUÐIGA,98,TLAJOMULCO DE ZUÐIGA,3447,951,952,0,1903,944,941,0,1885
14,JALISCO,12,TLAJOMULCO DE ZUÐIGA,98,TLAJOMULCO DE ZUÐIGA,3459,703,737,0,1440,694,731,0,1425
14,JALISCO,12,TLAJOMULCO DE ZUÐIGA,98,TLAJOMULCO DE ZUÐIGA,3460,221,248,0,469,219,247,0,466
14,JALISCO,12,TLAJOMULCO DE ZUÐIGA,98,TLAJOMULCO DE ZUÐIGA,3461,418,448,0,866,414,443,0,857
14,JALISCO,12,TLAJOMULCO DE ZUÐIGA,98,TLAJOMULCO DE ZUÐIGA,3462,626,593,0,1219,622,592,0,1214
14,JALISCO,12,TLAJOMULCO DE ZUÐIGA,98,TLAJOMULCO DE ZUÐIGA,3463,611,634,0,1245,608,628,0,1236
14,JALISCO,12,TLAJOMULCO DE ZUÐIGA,98,TLAJOMULCO DE ZUÐIGA,3464,435,438,0,873,433,436,0,869
14,JALISCO,12,TLAJOMULCO DE ZUÐIGA,98,TLAJOMULCO DE ZUÐIGA,3465,539,589,0,1128,534,583,0,1117
14,JALISCO,12,TLAJOMULCO DE ZUÐIGA,98,TLAJOMULCO DE ZUÐIGA,3466,518,516,0,1034,516,513,0,1029
14,JALISCO,12,TLAJOMULCO DE ZUÐIGA,98,TLAJOMULCO DE ZUÐIGA,3467,433,396,0,829,428,393,0,821
14,JALISCO,12,TLAJOMULCO DE ZUÐIGA,98,TLAJOMULCO DE ZUÐIGA,3468,4977,5133,0,10110,4948,5090,0,10038
14,JALISCO,12,TLAJOMULCO DE ZUÐIGA,98,TLAJOMULCO DE ZUÐIGA,3469,2694,2767,0,5461,2671,2745,0,5416
14,JALISCO,12,TLAJOMULCO DE ZUÐIGA,98,TLAJOMULCO DE ZUÐIGA,3470,2070,2113,0,4183,2055,2087,0,4142
14,JALISCO,12,TLAJOMULCO DE ZUÐIGA,98,TLAJOMULCO DE ZUÐIGA,3577,1269,1290,0,2559,1260,1277,0,2537
14,JALISCO,12,TLAJOMULCO DE ZUÐIGA,98,TLAJOMULCO DE ZUÐIGA,3578,1560,1676,0,3236,1544,1666,0,3210
14,JALISCO,12,TLAJOMULCO DE ZUÐIGA,98,TLAJOMULCO DE ZUÐIGA,3579,2598,2728,0,5326,2561,2696,0,5257
14,JALISCO,12,TLAJOMULCO DE ZUÐIGA,98,TLAJOMULCO DE ZUÐIGA,3580,790,897,0,1687,781,893,0,1674
14,JALISCO,12,TLAJOMULCO DE ZUÐIGA,98,TLAJOMULCO DE ZUÐIGA,3581,608,647,0,1255,600,636,0,1236
14,JALISCO,12,TLAJOMULCO DE ZUÐIGA,98,TLAJOMULCO DE ZUÐIGA,3582,1879,1992,0,3871,1862,1977,0,3839
14,JALISCO,12,TLAJOMULCO DE ZUÐIGA,98,TLAJOMULCO DE ZUÐIGA,3583,678,723,0,1401,671,717,0,1388
14,JALISCO,12,TLAJOMULCO DE ZUÐIGA,98,TLAJOMULCO DE ZUÐIGA,3584,782,810,0,1592,772,802,0,1574
14,JALISCO,12,TLAJOMULCO DE ZUÐIGA,98,TLAJOMULCO DE ZUÐIGA,3585,884,910,0,1794,870,903,0,1773
14,JALISCO,12,TLAJOMULCO DE ZUÐIGA,98,TLAJOMULCO DE ZUÐIGA,3586,2129,2236,0,4365,2109,2207,0,4316
14,JALISCO,12,TLAJOMULCO DE ZUÐIGA,98,TLAJOMULCO DE ZUÐIGA,3587,742,743,0,1485,732,739,0,1471
14,JALISCO,12,TLAJOMULCO DE ZUÐIGA,98,TLAJOMULCO DE ZUÐIGA,3588,854,928,0,1782,841,920,0,1761
14,JALISCO,12,TLAJOMULCO DE ZUÐIGA,98,TLAJOMULCO DE ZUÐIGA,3589,864,924,0,1788,857,918,0,1775
14,JALISCO,12,TLAJOMULCO DE ZUÐIGA,98,TLAJOMULCO DE ZUÐIGA,3590,942,1023,0,1965,933,1011,0,1944
14,JALISCO,12,TLAJOMULCO DE ZUÐIGA,98,TLAJOMULCO DE ZUÐIGA,3602,748,813,0,1561,741,806,0,1547
14,JALISCO,12,TLAJOMULCO DE ZUÐIGA,98,TLAJOMULCO DE ZUÐIGA,3603,986,1158,0,2144,972,1146,0,2118
14,JALISCO,12,TLAJOMULCO DE ZUÐIGA,98,TLAJOMULCO DE ZUÐIGA,3604,1114,1119,0,2233,1099,1103,0,2202
14,JALISCO,12,TLAJOMULCO DE ZUÐIGA,98,TLAJOMULCO DE ZUÐIGA,3605,1049,1111,0,2160,1041,1104,0,2145
14,JALISCO,12,TLAJOMULCO DE ZUÐIGA,98,TLAJOMULCO DE ZUÐIGA,3606,1461,1504,0,2965,1437,1489,0,2926
14,JALISCO,12,TLAJOMULCO DE ZUÐIGA,98,TLAJOMULCO DE ZUÐIGA,3607,632,678,0,1310,625,673,0,1298
14,JALISCO,12,TLAJOMULCO DE ZUÐIGA,98,TLAJOMULCO DE ZUÐIGA,3608,1433,1617,0,3050,1416,1603,0,3019
14,JALISCO,12,TLAJOMULCO DE ZUÐIGA,98,TLAJOMULCO DE ZUÐIGA,3609,1042,1210,0,2252,1036,1200,0,2236
14,JALISCO,12,TLAJOMULCO DE ZUÐIGA,98,TLAJOMULCO DE ZUÐIGA,3610,1094,1228,0,2322,1084,1216,0,2300
14,JALISCO,12,TLAJOMULCO DE ZUÐIGA,98,TLAJOMULCO DE ZUÐIGA,3611,1186,1409,1,2596,1175,1403,1,2579
14,JALISCO,12,TLAJOMULCO DE ZUÐIGA,98,TLAJOMULCO DE ZUÐIGA,3654,273,267,0,540,270,265,0,535
14,JALISCO,12,TLAJOMULCO DE ZUÐIGA,98,TLAJOMULCO DE ZUÐIGA,3655,964,1003,0,1967,951,995,0,1946
14,JALISCO,12,TLAJOMULCO DE ZUÐIGA,98,TLAJOMULCO DE ZUÐIGA,3656,707,751,0,1458,697,739,0,1436
14,JALISCO,12,TLAJOMULCO DE ZUÐIGA,98,TLAJOMULCO DE ZUÐIGA,3657,762,829,0,1591,758,823,0,1581
14,JALISCO,12,TLAJOMULCO DE ZUÐIGA,98,TLAJOMULCO DE ZUÐIGA,3679,611,551,0,1162,602,543,0,1145
14,JALISCO,12,TLAJOMULCO DE ZUÐIGA,98,TLAJOMULCO DE ZUÐIGA,3680,1339,1312,0,2651,1325,1301,0,2626
14,JALISCO,12,TLAJOMULCO DE ZUÐIGA,98,TLAJOMULCO DE ZUÐIGA,3732,959,1006,0,1965,948,992,0,1940
14,JALISCO,12,TLAJOMULCO DE ZUÐIGA,98,TLAJOMULCO DE ZUÐIGA,3733,922,1017,0,1939,919,1002,0,1921
14,JALISCO,12,TLAJOMULCO DE ZUÐIGA,98,TLAJOMULCO DE ZUÐIGA,3811,400,414,0,814,398,414,0,812
14,JALISCO,12,TLAJOMULCO DE ZUÐIGA,98,TLAJOMULCO DE ZUÐIGA,3812,922,881,0,1803,915,873,0,1788
14,JALISCO,12,TLAJOMULCO DE ZUÐIGA,98,TLAJOMULCO DE ZUÐIGA,3813,1820,1866,0,3686,1799,1848,0,3647
14,JALISCO,12,TLAJOMULCO DE ZUÐIGA,98,TLAJOMULCO DE ZUÐIGA,3814,1485,1519,0,3004,1461,1500,0,2961
14,JALISCO,12,TLAJOMULCO DE ZUÐIGA,98,TLAJOMULCO DE ZUÐIGA,3966,1232,1333,0,2565,1224,1324,0,2548
14,JALISCO,12,TLAJOMULCO DE ZUÐIGA,98,TLAJOMULCO DE ZUÐIGA,3967,1334,1429,0,2763,1322,1424,0,2746
14,JALISCO,12,TLAJOMULCO DE ZUÐIGA,98,TLAJOMULCO DE ZUÐIGA,3968,553,597,0,1150,550,593,0,1143
14,JALISCO,12,TLAJOMULCO DE ZUÐIGA,98,TLAJOMULCO DE ZUÐIGA,3969,1226,1382,0,2608,1211,1376,0,2587
14,JALISCO,12,TLAJOMULCO DE ZUÐIGA,98,TLAJOMULCO DE ZUÐIGA,3970,921,934,0,1855,916,932,0,1848
14,JALISCO,12,TLAJOMULCO DE ZUÐIGA,98,TLAJOMULCO DE ZUÐIGA,3971,1058,1134,0,2192,1049,1127,0,2176
14,JALISCO,12,TLAJOMULCO DE ZUÐIGA,120,ZAPOPAN,3119,3253,3153,0,6406,3223,3122,0,6345
14,JALISCO,12,TLAJOMULCO DE ZUÐIGA,120,ZAPOPAN,3153,2895,2919,0,5814,2875,2906,0,5781
14,JALISCO,12,TLAJOMULCO DE ZUÐIGA,120,ZAPOPAN,3206,1813,1864,0,3677,1799,1858,0,3657
14,JALISCO,12,TLAJOMULCO DE ZUÐIGA,120,ZAPOPAN,3207,659,670,0,1329,653,664,0,1317
14,JALISCO,12,TLAJOMULCO DE ZUÐIGA,120,ZAPOPAN,3208,1320,1387,0,2707,1309,1368,0,2677
14,JALISCO,12,TLAJOMULCO DE ZUÐIGA,120,ZAPOPAN,3209,812,809,0,1621,800,801,0,1601
14,JALISCO,12,TLAJOMULCO DE ZUÐIGA,120,ZAPOPAN,3214,1175,1209,0,2384,1164,1200,0,2364
14,JALISCO,12,TLAJOMULCO DE ZUÐIGA,120,ZAPOPAN,3216,2204,2398,0,4602,2180,2374,0,4554
14,JALISCO,12,TLAJOMULCO DE ZUÐIGA,120,ZAPOPAN,3217,2123,2293,0,4416,2110,2274,0,4384
14,JALISCO,12,TLAJOMULCO DE ZUÐIGA,120,ZAPOPAN,3218,927,989,0,1916,921,977,0,1898
14,JALISCO,12,TLAJOMULCO DE ZUÐIGA,120,ZAPOPAN,3219,3100,3664,0,6764,3077,3638,0,6715
14,JALISCO,12,TLAJOMULCO DE ZUÐIGA,120,ZAPOPAN,3220,685,800,0,1485,682,790,0,1472
14,JALISCO,12,TLAJOMULCO DE ZUÐIGA,120,ZAPOPAN,3221,745,714,0,1459,734,709,0,1443
14,JALISCO,12,TLAJOMULCO DE ZUÐIGA,120,ZAPOPAN,3222,1101,1090,0,2191,1099,1082,0,2181
14,JALISCO,12,TLAJOMULCO DE ZUÐIGA,120,ZAPOPAN,3223,2313,2331,0,4644,2295,2306,0,4601
14,JALISCO,12,TLAJOMULCO DE ZUÐIGA,120,ZAPOPAN,3224,1040,1003,0,2043,1025,993,0,2018
14,JALISCO,12,TLAJOMULCO DE ZUÐIGA,120,ZAPOPAN,3225,3614,3733,0,7347,3567,3701,0,7268
14,JALISCO,12,TLAJOMULCO DE ZUÐIGA,120,ZAPOPAN,3235,3292,3477,0,6769,3270,3434,0,6704
14,JALISCO,12,TLAJOMULCO DE ZUÐIGA,120,ZAPOPAN,3236,1213,1222,0,2435,1201,1215,0,2416
14,JALISCO,12,TLAJOMULCO DE ZUÐIGA,120,ZAPOPAN,3237,1054,1301,0,2355,1043,1294,0,2337
14,JALISCO,12,TLAJOMULCO DE ZUÐIGA,120,ZAPOPAN,3529,409,441,0,850,407,435,0,842
14,JALISCO,12,TLAJOMULCO DE ZUÐIGA,120,ZAPOPAN,3530,510,523,0,1033,503,518,0,1021
14,JALISCO,12,TLAJOMULCO DE ZUÐIGA,120,ZAPOPAN,3532,534,533,0,1067,528,527,0,1055
14,JALISCO,12,TLAJOMULCO DE ZUÐIGA,120,ZAPOPAN,3534,595,658,0,1253,590,652,0,1242
14,JALISCO,12,TLAJOMULCO DE ZUÐIGA,120,ZAPOPAN,3535,589,566,0,1155,582,560,0,1142
14,JALISCO,12,TLAJOMULCO DE ZUÐIGA,120,ZAPOPAN,3536,589,595,0,1184,585,594,0,1179
14,JALISCO,12,TLAJOMULCO DE ZUÐIGA,120,ZAPOPAN,3539,626,625,0,1251,620,620,0,1240
14,JALISCO,12,TLAJOMULCO DE ZUÐIGA,120,ZAPOPAN,3540,662,682,0,1344,660,677,0,1337
14,JALISCO,12,TLAJOMULCO DE ZUÐIGA,120,ZAPOPAN,3541,532,577,0,1109,523,571,0,1094
14,JALISCO,12,TLAJOMULCO DE ZUÐIGA,120,ZAPOPAN,3545,770,833,0,1603,761,825,0,1586
14,JALISCO,12,TLAJOMULCO DE ZUÐIGA,120,ZAPOPAN,3546,343,342,0,685,342,339,0,681
14,JALISCO,12,TLAJOMULCO DE ZUÐIGA,120,ZAPOPAN,3547,516,516,0,1032,507,513,0,1020
14,JALISCO,12,TLAJOMULCO DE ZUÐIGA,120,ZAPOPAN,3548,450,487,0,937,443,483,0,926
14,JALISCO,12,TLAJOMULCO DE ZUÐIGA,120,ZAPOPAN,3634,1890,2045,0,3935,1880,2028,0,3908
14,JALISCO,12,TLAJOMULCO DE ZUÐIGA,120,ZAPOPAN,3635,1569,1771,0,3340,1561,1761,0,3322
14,JALISCO,12,TLAJOMULCO DE ZUÐIGA,120,ZAPOPAN,3636,1648,1868,0,3516,1636,1855,0,3491
14,JALISCO,12,TLAJOMULCO DE ZUÐIGA,120,ZAPOPAN,3637,1397,1508,0,2905,1388,1498,0,2886
14,JALISCO,12,TLAJOMULCO DE ZUÐIGA,120,ZAPOPAN,3638,909,975,0,1884,900,970,0,1870
14,JALISCO,12,TLAJOMULCO DE ZUÐIGA,120,ZAPOPAN,3639,506,534,0,1040,503,528,0,1031
14,JALISCO,12,TLAJOMULCO DE ZUÐIGA,120,ZAPOPAN,3640,1508,1604,0,3112,1499,1590,0,3089
14,JALISCO,12,TLAJOMULCO DE ZUÐIGA,120,ZAPOPAN,3641,1025,1080,0,2105,1011,1073,0,2084
14,JALISCO,12,TLAJOMULCO DE ZUÐIGA,120,ZAPOPAN,3642,975,1102,0,2077,961,1083,0,2044
14,JALISCO,12,TLAJOMULCO DE ZUÐIGA,120,ZAPOPAN,3643,1000,1098,0,2098,990,1091,0,2081
14,JALISCO,12,TLAJOMULCO DE ZUÐIGA,120,ZAPOPAN,3644,428,476,0,904,423,468,0,891
14,JALISCO,12,TLAJOMULCO DE ZUÐIGA,120,ZAPOPAN,3678,845,941,0,1786,836,935,0,1771
14,JALISCO,13,SAN PEDRO TLAQUEPAQUE,41,GUADALAJARA,857,755,854,0,1609,748,846,0,1594
14,JALISCO,13,SAN PEDRO TLAQUEPAQUE,41,GUADALAJARA,858,298,339,0,637,294,338,0,632
14,JALISCO,13,SAN PEDRO TLAQUEPAQUE,41,GUADALAJARA,859,520,593,0,1113,512,590,0,1102
14,JALISCO,13,SAN PEDRO TLAQUEPAQUE,41,GUADALAJARA,860,346,405,0,751,342,404,0,746
14,JALISCO,13,SAN PEDRO TLAQUEPAQUE,41,GUADALAJARA,861,423,496,0,919,420,490,0,910
14,JALISCO,13,SAN PEDRO TLAQUEPAQUE,41,GUADALAJARA,862,700,769,0,1469,696,763,0,1459
14,JALISCO,13,SAN PEDRO TLAQUEPAQUE,41,GUADALAJARA,863,660,752,0,1412,655,744,0,1399
14,JALISCO,13,SAN PEDRO TLAQUEPAQUE,41,GUADALAJARA,864,418,445,0,863,415,443,0,858
14,JALISCO,13,SAN PEDRO TLAQUEPAQUE,41,GUADALAJARA,865,390,417,0,807,385,415,0,800
14,JALISCO,13,SAN PEDRO TLAQUEPAQUE,41,GUADALAJARA,866,402,448,0,850,396,446,0,842
14,JALISCO,13,SAN PEDRO TLAQUEPAQUE,41,GUADALAJARA,867,279,323,0,602,275,319,0,594
14,JALISCO,13,SAN PEDRO TLAQUEPAQUE,41,GUADALAJARA,868,744,833,0,1577,736,828,0,1564
14,JALISCO,13,SAN PEDRO TLAQUEPAQUE,41,GUADALAJARA,869,770,867,0,1637,763,859,0,1622
14,JALISCO,13,SAN PEDRO TLAQUEPAQUE,41,GUADALAJARA,870,590,667,0,1257,583,662,0,1245
14,JALISCO,13,SAN PEDRO TLAQUEPAQUE,41,GUADALAJARA,871,595,633,0,1228,592,622,0,1214
14,JALISCO,13,SAN PEDRO TLAQUEPAQUE,41,GUADALAJARA,872,557,598,0,1155,553,596,0,1149
14,JALISCO,13,SAN PEDRO TLAQUEPAQUE,41,GUADALAJARA,873,1098,1139,1,2238,1089,1125,0,2214
14,JALISCO,13,SAN PEDRO TLAQUEPAQUE,41,GUADALAJARA,874,1234,1256,0,2490,1225,1242,0,2467
14,JALISCO,13,SAN PEDRO TLAQUEPAQUE,41,GUADALAJARA,875,1136,1161,0,2297,1124,1153,0,2277
14,JALISCO,13,SAN PEDRO TLAQUEPAQUE,41,GUADALAJARA,876,1348,1450,0,2798,1344,1443,0,2787
14,JALISCO,13,SAN PEDRO TLAQUEPAQUE,41,GUADALAJARA,877,1009,1057,0,2066,1001,1046,0,2047
14,JALISCO,13,SAN PEDRO TLAQUEPAQUE,41,GUADALAJARA,878,723,793,0,1516,717,785,0,1502
14,JALISCO,13,SAN PEDRO TLAQUEPAQUE,41,GUADALAJARA,879,661,681,0,1342,655,677,0,1332
14,JALISCO,13,SAN PEDRO TLAQUEPAQUE,41,GUADALAJARA,880,1105,1154,0,2259,1096,1143,0,2239
14,JALISCO,13,SAN PEDRO TLAQUEPAQUE,41,GUADALAJARA,881,880,949,0,1829,870,943,0,1813
14,JALISCO,13,SAN PEDRO TLAQUEPAQUE,41,GUADALAJARA,882,839,875,0,1714,825,865,0,1690
14,JALISCO,13,SAN PEDRO TLAQUEPAQUE,41,GUADALAJARA,883,750,832,0,1582,743,823,0,1566
14,JALISCO,13,SAN PEDRO TLAQUEPAQUE,41,GUADALAJARA,884,680,686,0,1366,674,681,0,1355
14,JALISCO,13,SAN PEDRO TLAQUEPAQUE,41,GUADALAJARA,885,896,989,0,1885,891,982,0,1873
14,JALISCO,13,SAN PEDRO TLAQUEPAQUE,41,GUADALAJARA,886,1083,1162,0,2245,1076,1156,0,2232
14,JALISCO,13,SAN PEDRO TLAQUEPAQUE,41,GUADALAJARA,887,1044,1268,0,2312,1031,1258,0,2289
14,JALISCO,13,SAN PEDRO TLAQUEPAQUE,41,GUADALAJARA,890,543,645,0,1188,538,643,0,1181
14,JALISCO,13,SAN PEDRO TLAQUEPAQUE,41,GUADALAJARA,891,902,1043,0,1945,894,1035,0,1929
14,JALISCO,13,SAN PEDRO TLAQUEPAQUE,41,GUADALAJARA,892,520,632,0,1152,516,630,0,1146
14,JALISCO,13,SAN PEDRO TLAQUEPAQUE,41,GUADALAJARA,893,1135,1196,0,2331,1129,1189,0,2318
14,JALISCO,13,SAN PEDRO TLAQUEPAQUE,41,GUADALAJARA,894,1065,1128,0,2193,1060,1112,0,2172
14,JALISCO,13,SAN PEDRO TLAQUEPAQUE,41,GUADALAJARA,895,1104,1130,0,2234,1094,1119,0,2213
14,JALISCO,13,SAN PEDRO TLAQUEPAQUE,41,GUADALAJARA,896,600,652,0,1252,594,644,0,1238
14,JALISCO,13,SAN PEDRO TLAQUEPAQUE,41,GUADALAJARA,897,470,492,0,962,465,490,0,955
14,JALISCO,13,SAN PEDRO TLAQUEPAQUE,41,GUADALAJARA,898,585,646,0,1231,579,641,0,1220
14,JALISCO,13,SAN PEDRO TLAQUEPAQUE,41,GUADALAJARA,899,785,865,0,1650,777,857,0,1634
14,JALISCO,13,SAN PEDRO TLAQUEPAQUE,41,GUADALAJARA,900,867,953,0,1820,860,944,0,1804
14,JALISCO,13,SAN PEDRO TLAQUEPAQUE,41,GUADALAJARA,901,954,927,0,1881,947,921,0,1868
14,JALISCO,13,SAN PEDRO TLAQUEPAQUE,41,GUADALAJARA,902,1421,1535,0,2956,1415,1527,0,2942
14,JALISCO,13,SAN PEDRO TLAQUEPAQUE,41,GUADALAJARA,903,808,887,0,1695,800,883,0,1683
14,JALISCO,13,SAN PEDRO TLAQUEPAQUE,41,GUADALAJARA,904,1009,1163,0,2172,997,1149,0,2146
14,JALISCO,13,SAN PEDRO TLAQUEPAQUE,41,GUADALAJARA,905,645,670,0,1315,641,667,0,1308
14,JALISCO,13,SAN PEDRO TLAQUEPAQUE,41,GUADALAJARA,906,593,554,0,1147,589,547,0,1136
14,JALISCO,13,SAN PEDRO TLAQUEPAQUE,41,GUADALAJARA,907,986,1051,0,2037,976,1037,0,2013
14,JALISCO,13,SAN PEDRO TLAQUEPAQUE,41,GUADALAJARA,908,604,668,0,1272,600,663,0,1263
14,JALISCO,13,SAN PEDRO TLAQUEPAQUE,41,GUADALAJARA,909,485,514,0,999,480,505,0,985
14,JALISCO,13,SAN PEDRO TLAQUEPAQUE,41,GUADALAJARA,910,877,984,0,1861,872,969,0,1841
14,JALISCO,13,SAN PEDRO TLAQUEPAQUE,41,GUADALAJARA,911,1083,1166,0,2249,1072,1155,0,2227
14,JALISCO,13,SAN PEDRO TLAQUEPAQUE,41,GUADALAJARA,912,598,634,0,1232,593,627,0,1220
14,JALISCO,13,SAN PEDRO TLAQUEPAQUE,41,GUADALAJARA,913,594,654,0,1248,584,649,0,1233
14,JALISCO,13,SAN PEDRO TLAQUEPAQUE,41,GUADALAJARA,914,723,770,0,1493,720,762,0,1482
14,JALISCO,13,SAN PEDRO TLAQUEPAQUE,41,GUADALAJARA,915,553,597,0,1150,546,592,0,1138
14,JALISCO,13,SAN PEDRO TLAQUEPAQUE,41,GUADALAJARA,916,1605,1843,0,3448,1590,1829,0,3419
14,JALISCO,13,SAN PEDRO TLAQUEPAQUE,41,GUADALAJARA,917,891,907,0,1798,888,900,0,1788
14,JALISCO,13,SAN PEDRO TLAQUEPAQUE,41,GUADALAJARA,918,1121,1167,0,2288,1116,1157,0,2273
14,JALISCO,13,SAN PEDRO TLAQUEPAQUE,41,GUADALAJARA,919,942,932,0,1874,930,925,0,1855
14,JALISCO,13,SAN PEDRO TLAQUEPAQUE,41,GUADALAJARA,920,1242,1311,0,2553,1224,1296,0,2520
14,JALISCO,13,SAN PEDRO TLAQUEPAQUE,41,GUADALAJARA,921,826,810,0,1636,815,802,0,1617
14,JALISCO,13,SAN PEDRO TLAQUEPAQUE,41,GUADALAJARA,922,1234,1312,0,2546,1216,1307,0,2523
14,JALISCO,13,SAN PEDRO TLAQUEPAQUE,41,GUADALAJARA,923,1213,1325,0,2538,1205,1310,0,2515
14,JALISCO,13,SAN PEDRO TLAQUEPAQUE,41,GUADALAJARA,924,396,452,0,848,392,448,0,840
14,JALISCO,13,SAN PEDRO TLAQUEPAQUE,41,GUADALAJARA,925,1371,1479,0,2850,1356,1473,0,2829
14,JALISCO,13,SAN PEDRO TLAQUEPAQUE,41,GUADALAJARA,926,1321,1443,0,2764,1312,1430,0,2742
14,JALISCO,13,SAN PEDRO TLAQUEPAQUE,41,GUADALAJARA,927,916,984,0,1900,909,977,0,1886
14,JALISCO,13,SAN PEDRO TLAQUEPAQUE,41,GUADALAJARA,928,1181,1153,0,2334,1166,1149,0,2315
14,JALISCO,13,SAN PEDRO TLAQUEPAQUE,41,GUADALAJARA,2599,650,691,0,1341,643,687,0,1330
14,JALISCO,13,SAN PEDRO TLAQUEPAQUE,41,GUADALAJARA,2600,607,626,0,1233,602,622,0,1224
14,JALISCO,13,SAN PEDRO TLAQUEPAQUE,41,GUADALAJARA,3315,659,729,0,1388,651,724,0,1375
14,JALISCO,13,SAN PEDRO TLAQUEPAQUE,99,SAN PEDRO TLAQUEPAQUE,2571,344,416,0,760,344,413,0,757
14,JALISCO,13,SAN PEDRO TLAQUEPAQUE,99,SAN PEDRO TLAQUEPAQUE,2572,316,348,0,664,312,348,0,660
14,JALISCO,13,SAN PEDRO TLAQUEPAQUE,99,SAN PEDRO TLAQUEPAQUE,2573,404,478,0,882,400,472,0,872
14,JALISCO,13,SAN PEDRO TLAQUEPAQUE,99,SAN PEDRO TLAQUEPAQUE,2574,525,606,0,1131,520,602,0,1122
14,JALISCO,13,SAN PEDRO TLAQUEPAQUE,99,SAN PEDRO TLAQUEPAQUE,2575,459,501,0,960,455,501,0,956
14,JALISCO,13,SAN PEDRO TLAQUEPAQUE,99,SAN PEDRO TLAQUEPAQUE,2576,963,1110,0,2073,952,1101,0,2053
14,JALISCO,13,SAN PEDRO TLAQUEPAQUE,99,SAN PEDRO TLAQUEPAQUE,2577,1010,1100,0,2110,1001,1089,0,2090
14,JALISCO,13,SAN PEDRO TLAQUEPAQUE,99,SAN PEDRO TLAQUEPAQUE,2578,928,1064,0,1992,917,1053,0,1970
14,JALISCO,13,SAN PEDRO TLAQUEPAQUE,99,SAN PEDRO TLAQUEPAQUE,2579,526,607,0,1133,523,603,0,1126
14,JALISCO,13,SAN PEDRO TLAQUEPAQUE,99,SAN PEDRO TLAQUEPAQUE,2580,1601,1749,0,3350,1585,1729,0,3314
14,JALISCO,13,SAN PEDRO TLAQUEPAQUE,99,SAN PEDRO TLAQUEPAQUE,2581,452,469,0,921,447,463,0,910
14,JALISCO,13,SAN PEDRO TLAQUEPAQUE,99,SAN PEDRO TLAQUEPAQUE,2582,889,976,0,1865,876,971,0,1847
14,JALISCO,13,SAN PEDRO TLAQUEPAQUE,99,SAN PEDRO TLAQUEPAQUE,2583,1557,1584,0,3141,1545,1570,0,3115
14,JALISCO,13,SAN PEDRO TLAQUEPAQUE,99,SAN PEDRO TLAQUEPAQUE,2584,1058,1153,0,2211,1048,1144,0,2192
14,JALISCO,13,SAN PEDRO TLAQUEPAQUE,99,SAN PEDRO TLAQUEPAQUE,2594,2130,2176,0,4306,2111,2157,0,4268
14,JALISCO,13,SAN PEDRO TLAQUEPAQUE,99,SAN PEDRO TLAQUEPAQUE,2595,1914,2017,0,3931,1894,1998,0,3892
14,JALISCO,13,SAN PEDRO TLAQUEPAQUE,99,SAN PEDRO TLAQUEPAQUE,2596,2095,2225,0,4320,2073,2204,0,4277
14,JALISCO,13,SAN PEDRO TLAQUEPAQUE,99,SAN PEDRO TLAQUEPAQUE,2597,1445,1479,0,2924,1427,1458,0,2885
14,JALISCO,13,SAN PEDRO TLAQUEPAQUE,99,SAN PEDRO TLAQUEPAQUE,2598,1072,1133,0,2205,1062,1126,0,2188
14,JALISCO,13,SAN PEDRO TLAQUEPAQUE,99,SAN PEDRO TLAQUEPAQUE,2601,784,864,0,1648,775,859,0,1634
14,JALISCO,13,SAN PEDRO TLAQUEPAQUE,99,SAN PEDRO TLAQUEPAQUE,2602,1327,1461,0,2788,1317,1448,0,2765
14,JALISCO,13,SAN PEDRO TLAQUEPAQUE,99,SAN PEDRO TLAQUEPAQUE,2603,1446,1497,0,2943,1430,1482,0,2912
14,JALISCO,13,SAN PEDRO TLAQUEPAQUE,99,SAN PEDRO TLAQUEPAQUE,2605,2205,2319,0,4524,2186,2295,0,4481
14,JALISCO,13,SAN PEDRO TLAQUEPAQUE,99,SAN PEDRO TLAQUEPAQUE,2606,2688,2750,0,5438,2672,2720,0,5392
14,JALISCO,13,SAN PEDRO TLAQUEPAQUE,99,SAN PEDRO TLAQUEPAQUE,2614,3816,3903,0,7719,3780,3865,0,7645
14,JALISCO,13,SAN PEDRO TLAQUEPAQUE,99,SAN PEDRO TLAQUEPAQUE,2615,3399,3296,0,6695,3351,3258,0,6609
14,JALISCO,13,SAN PEDRO TLAQUEPAQUE,99,SAN PEDRO TLAQUEPAQUE,2617,3659,3769,0,7428,3620,3728,0,7348
14,JALISCO,13,SAN PEDRO TLAQUEPAQUE,99,SAN PEDRO TLAQUEPAQUE,2620,1859,2047,0,3906,1842,2025,0,3867
14,JALISCO,13,SAN PEDRO TLAQUEPAQUE,99,SAN PEDRO TLAQUEPAQUE,2621,2166,2472,0,4638,2150,2454,0,4604
14,JALISCO,13,SAN PEDRO TLAQUEPAQUE,99,SAN PEDRO TLAQUEPAQUE,2622,618,717,0,1335,609,710,0,1319
14,JALISCO,13,SAN PEDRO TLAQUEPAQUE,99,SAN PEDRO TLAQUEPAQUE,2623,923,1112,0,2035,915,1104,0,2019
14,JALISCO,13,SAN PEDRO TLAQUEPAQUE,99,SAN PEDRO TLAQUEPAQUE,2624,2626,2902,0,5528,2615,2884,0,5499
14,JALISCO,13,SAN PEDRO TLAQUEPAQUE,99,SAN PEDRO TLAQUEPAQUE,3172,768,864,0,1632,760,851,0,1611
14,JALISCO,13,SAN PEDRO TLAQUEPAQUE,99,SAN PEDRO TLAQUEPAQUE,3199,1280,1377,0,2657,1274,1372,0,2646
14,JALISCO,13,SAN PEDRO TLAQUEPAQUE,99,SAN PEDRO TLAQUEPAQUE,3201,1673,1845,0,3518,1667,1831,0,3498
14,JALISCO,13,SAN PEDRO TLAQUEPAQUE,99,SAN PEDRO TLAQUEPAQUE,3202,766,839,0,1605,755,833,0,1588
14,JALISCO,13,SAN PEDRO TLAQUEPAQUE,99,SAN PEDRO TLAQUEPAQUE,3203,499,511,0,1010,496,505,0,1001
14,JALISCO,13,SAN PEDRO TLAQUEPAQUE,99,SAN PEDRO TLAQUEPAQUE,3204,1069,1226,0,2295,1059,1216,0,2275
14,JALISCO,13,SAN PEDRO TLAQUEPAQUE,99,SAN PEDRO TLAQUEPAQUE,3312,1033,1090,0,2123,1019,1083,0,2102
14,JALISCO,13,SAN PEDRO TLAQUEPAQUE,99,SAN PEDRO TLAQUEPAQUE,3313,1084,1181,0,2265,1073,1172,0,2245
14,JALISCO,13,SAN PEDRO TLAQUEPAQUE,99,SAN PEDRO TLAQUEPAQUE,3314,502,516,0,1018,497,513,0,1010
14,JALISCO,13,SAN PEDRO TLAQUEPAQUE,99,SAN PEDRO TLAQUEPAQUE,3316,139,136,0,275,136,135,0,271
14,JALISCO,13,SAN PEDRO TLAQUEPAQUE,99,SAN PEDRO TLAQUEPAQUE,3317,3435,3703,0,7138,3410,3686,0,7096
14,JALISCO,13,SAN PEDRO TLAQUEPAQUE,99,SAN PEDRO TLAQUEPAQUE,3318,645,709,0,1354,642,703,0,1345
14,JALISCO,13,SAN PEDRO TLAQUEPAQUE,99,SAN PEDRO TLAQUEPAQUE,3319,56,52,0,108,56,51,0,107
14,JALISCO,13,SAN PEDRO TLAQUEPAQUE,99,SAN PEDRO TLAQUEPAQUE,3320,190,171,0,361,187,171,0,358
14,JALISCO,13,SAN PEDRO TLAQUEPAQUE,99,SAN PEDRO TLAQUEPAQUE,3321,630,738,0,1368,625,736,0,1361
14,JALISCO,13,SAN PEDRO TLAQUEPAQUE,99,SAN PEDRO TLAQUEPAQUE,3322,800,866,0,1666,795,859,0,1654
14,JALISCO,13,SAN PEDRO TLAQUEPAQUE,99,SAN PEDRO TLAQUEPAQUE,3323,264,272,0,536,263,272,0,535
14,JALISCO,13,SAN PEDRO TLAQUEPAQUE,99,SAN PEDRO TLAQUEPAQUE,3324,1579,1811,1,3391,1567,1793,1,3361
14,JALISCO,13,SAN PEDRO TLAQUEPAQUE,99,SAN PEDRO TLAQUEPAQUE,3325,343,342,0,685,337,337,0,674
14,JALISCO,13,SAN PEDRO TLAQUEPAQUE,99,SAN PEDRO TLAQUEPAQUE,3326,85,98,0,183,84,98,0,182
14,JALISCO,13,SAN PEDRO TLAQUEPAQUE,99,SAN PEDRO TLAQUEPAQUE,3327,479,429,0,908,473,423,0,896
14,JALISCO,13,SAN PEDRO TLAQUEPAQUE,99,SAN PEDRO TLAQUEPAQUE,3328,420,409,0,829,417,407,0,824
14,JALISCO,13,SAN PEDRO TLAQUEPAQUE,99,SAN PEDRO TLAQUEPAQUE,3329,444,417,0,861,441,415,0,856
14,JALISCO,13,SAN PEDRO TLAQUEPAQUE,99,SAN PEDRO TLAQUEPAQUE,3330,332,416,0,748,331,410,0,741
14,JALISCO,13,SAN PEDRO TLAQUEPAQUE,99,SAN PEDRO TLAQUEPAQUE,3331,410,444,0,854,404,440,0,844
14,JALISCO,13,SAN PEDRO TLAQUEPAQUE,99,SAN PEDRO TLAQUEPAQUE,3332,411,410,0,821,410,409,0,819
14,JALISCO,13,SAN PEDRO TLAQUEPAQUE,99,SAN PEDRO TLAQUEPAQUE,3333,397,425,0,822,396,423,0,819
14,JALISCO,13,SAN PEDRO TLAQUEPAQUE,99,SAN PEDRO TLAQUEPAQUE,3334,508,509,0,1017,505,505,0,1010
14,JALISCO,13,SAN PEDRO TLAQUEPAQUE,99,SAN PEDRO TLAQUEPAQUE,3335,529,521,0,1050,522,518,0,1040
14,JALISCO,13,SAN PEDRO TLAQUEPAQUE,99,SAN PEDRO TLAQUEPAQUE,3336,493,530,0,1023,488,524,0,1012
14,JALISCO,13,SAN PEDRO TLAQUEPAQUE,99,SAN PEDRO TLAQUEPAQUE,3337,505,580,0,1085,501,578,0,1079
14,JALISCO,13,SAN PEDRO TLAQUEPAQUE,99,SAN PEDRO TLAQUEPAQUE,3338,447,492,0,939,441,488,0,929
14,JALISCO,13,SAN PEDRO TLAQUEPAQUE,99,SAN PEDRO TLAQUEPAQUE,3339,541,567,0,1108,540,562,0,1102
14,JALISCO,13,SAN PEDRO TLAQUEPAQUE,99,SAN PEDRO TLAQUEPAQUE,3340,467,476,0,943,461,473,0,934
14,JALISCO,13,SAN PEDRO TLAQUEPAQUE,99,SAN PEDRO TLAQUEPAQUE,3341,598,577,0,1175,594,576,0,1170
14,JALISCO,13,SAN PEDRO TLAQUEPAQUE,99,SAN PEDRO TLAQUEPAQUE,3342,647,679,0,1326,645,677,0,1322
14,JALISCO,13,SAN PEDRO TLAQUEPAQUE,99,SAN PEDRO TLAQUEPAQUE,3343,494,495,0,989,489,488,0,977
14,JALISCO,13,SAN PEDRO TLAQUEPAQUE,99,SAN PEDRO TLAQUEPAQUE,3344,593,550,0,1143,588,546,0,1134
14,JALISCO,13,SAN PEDRO TLAQUEPAQUE,99,SAN PEDRO TLAQUEPAQUE,3345,519,521,0,1040,512,516,0,1028
14,JALISCO,13,SAN PEDRO TLAQUEPAQUE,99,SAN PEDRO TLAQUEPAQUE,3346,559,593,0,1152,554,590,0,1144
14,JALISCO,13,SAN PEDRO TLAQUEPAQUE,99,SAN PEDRO TLAQUEPAQUE,3347,583,610,0,1193,579,605,0,1184
14,JALISCO,13,SAN PEDRO TLAQUEPAQUE,99,SAN PEDRO TLAQUEPAQUE,3348,617,614,0,1231,614,609,0,1223
14,JALISCO,13,SAN PEDRO TLAQUEPAQUE,99,SAN PEDRO TLAQUEPAQUE,3349,478,555,0,1033,473,554,0,1027
14,JALISCO,13,SAN PEDRO TLAQUEPAQUE,99,SAN PEDRO TLAQUEPAQUE,3350,593,606,0,1199,586,593,0,1179
14,JALISCO,13,SAN PEDRO TLAQUEPAQUE,99,SAN PEDRO TLAQUEPAQUE,3351,677,709,0,1386,676,703,0,1379
14,JALISCO,13,SAN PEDRO TLAQUEPAQUE,99,SAN PEDRO TLAQUEPAQUE,3352,585,604,0,1189,577,600,0,1177
14,JALISCO,13,SAN PEDRO TLAQUEPAQUE,99,SAN PEDRO TLAQUEPAQUE,3353,524,478,0,1002,518,475,0,993
14,JALISCO,13,SAN PEDRO TLAQUEPAQUE,99,SAN PEDRO TLAQUEPAQUE,3354,545,543,0,1088,537,539,0,1076
14,JALISCO,13,SAN PEDRO TLAQUEPAQUE,99,SAN PEDRO TLAQUEPAQUE,3355,194,203,0,397,193,203,0,396
14,JALISCO,13,SAN PEDRO TLAQUEPAQUE,99,SAN PEDRO TLAQUEPAQUE,3734,921,1024,0,1945,915,1017,0,1932
14,JALISCO,13,SAN PEDRO TLAQUEPAQUE,99,SAN PEDRO TLAQUEPAQUE,3735,954,972,0,1926,946,962,0,1908
14,JALISCO,13,SAN PEDRO TLAQUEPAQUE,99,SAN PEDRO TLAQUEPAQUE,3826,1055,1195,0,2250,1050,1183,0,2233
14,JALISCO,13,SAN PEDRO TLAQUEPAQUE,99,SAN PEDRO TLAQUEPAQUE,3827,843,854,0,1697,840,849,0,1689
14,JALISCO,13,SAN PEDRO TLAQUEPAQUE,99,SAN PEDRO TLAQUEPAQUE,3828,968,943,0,1911,962,935,0,1897
14,JALISCO,13,SAN PEDRO TLAQUEPAQUE,99,SAN PEDRO TLAQUEPAQUE,3829,1538,1578,0,3116,1529,1569,0,3098
14,JALISCO,13,SAN PEDRO TLAQUEPAQUE,99,SAN PEDRO TLAQUEPAQUE,3830,1376,1429,0,2805,1357,1417,0,2774
14,JALISCO,13,SAN PEDRO TLAQUEPAQUE,99,SAN PEDRO TLAQUEPAQUE,3831,640,604,0,1244,630,596,0,1226
14,JALISCO,13,SAN PEDRO TLAQUEPAQUE,99,SAN PEDRO TLAQUEPAQUE,3979,1122,1157,0,2279,1115,1150,0,2265
14,JALISCO,13,SAN PEDRO TLAQUEPAQUE,99,SAN PEDRO TLAQUEPAQUE,3980,1009,1049,0,2058,1003,1038,0,2041
14,JALISCO,13,SAN PEDRO TLAQUEPAQUE,99,SAN PEDRO TLAQUEPAQUE,3981,800,886,0,1686,796,879,0,1675
14,JALISCO,13,SAN PEDRO TLAQUEPAQUE,99,SAN PEDRO TLAQUEPAQUE,3982,1287,1378,0,2665,1278,1360,0,2638
14,JALISCO,13,SAN PEDRO TLAQUEPAQUE,99,SAN PEDRO TLAQUEPAQUE,3983,1279,1374,0,2653,1264,1359,0,2623
14,JALISCO,14,TLAJOMULCO DE ZUÐIGA,98,TLAJOMULCO DE ZUÐIGA,2443,893,994,0,1887,883,982,0,1865
14,JALISCO,14,TLAJOMULCO DE ZUÐIGA,98,TLAJOMULCO DE ZUÐIGA,2450,1759,1893,0,3652,1751,1876,0,3627
14,JALISCO,14,TLAJOMULCO DE ZUÐIGA,98,TLAJOMULCO DE ZUÐIGA,2452,2795,2890,0,5685,2777,2866,0,5643
14,JALISCO,14,TLAJOMULCO DE ZUÐIGA,98,TLAJOMULCO DE ZUÐIGA,2459,1529,1542,0,3071,1517,1529,0,3046
14,JALISCO,14,TLAJOMULCO DE ZUÐIGA,98,TLAJOMULCO DE ZUÐIGA,2460,1734,1803,0,3537,1722,1797,0,3519
14,JALISCO,14,TLAJOMULCO DE ZUÐIGA,98,TLAJOMULCO DE ZUÐIGA,2461,956,1048,0,2004,946,1037,0,1983
14,JALISCO,14,TLAJOMULCO DE ZUÐIGA,98,TLAJOMULCO DE ZUÐIGA,2463,1779,1817,0,3596,1750,1791,0,3541
14,JALISCO,14,TLAJOMULCO DE ZUÐIGA,98,TLAJOMULCO DE ZUÐIGA,2464,1641,1706,0,3347,1614,1681,0,3295
14,JALISCO,14,TLAJOMULCO DE ZUÐIGA,98,TLAJOMULCO DE ZUÐIGA,2467,4289,4529,0,8818,4247,4495,0,8742
14,JALISCO,14,TLAJOMULCO DE ZUÐIGA,98,TLAJOMULCO DE ZUÐIGA,2468,2828,2850,0,5678,2810,2837,0,5647
14,JALISCO,14,TLAJOMULCO DE ZUÐIGA,98,TLAJOMULCO DE ZUÐIGA,2471,997,1030,0,2027,958,996,0,1954
14,JALISCO,14,TLAJOMULCO DE ZUÐIGA,98,TLAJOMULCO DE ZUÐIGA,3397,800,836,0,1636,795,832,0,1627
14,JALISCO,14,TLAJOMULCO DE ZUÐIGA,98,TLAJOMULCO DE ZUÐIGA,3398,1057,1180,0,2237,1050,1172,0,2222
14,JALISCO,14,TLAJOMULCO DE ZUÐIGA,98,TLAJOMULCO DE ZUÐIGA,3399,1105,1136,0,2241,1097,1124,0,2221
14,JALISCO,14,TLAJOMULCO DE ZUÐIGA,98,TLAJOMULCO DE ZUÐIGA,3400,719,799,0,1518,713,795,0,1508
14,JALISCO,14,TLAJOMULCO DE ZUÐIGA,98,TLAJOMULCO DE ZUÐIGA,3401,731,794,0,1525,724,792,0,1516
14,JALISCO,14,TLAJOMULCO DE ZUÐIGA,98,TLAJOMULCO DE ZUÐIGA,3404,765,777,0,1542,762,772,0,1534
14,JALISCO,14,TLAJOMULCO DE ZUÐIGA,98,TLAJOMULCO DE ZUÐIGA,3405,803,899,0,1702,797,891,0,1688
14,JALISCO,14,TLAJOMULCO DE ZUÐIGA,98,TLAJOMULCO DE ZUÐIGA,3406,986,1044,0,2030,979,1035,0,2014
14,JALISCO,14,TLAJOMULCO DE ZUÐIGA,98,TLAJOMULCO DE ZUÐIGA,3407,3969,4331,0,8300,3910,4270,0,8180
14,JALISCO,14,TLAJOMULCO DE ZUÐIGA,98,TLAJOMULCO DE ZUÐIGA,3408,980,983,0,1963,972,974,0,1946
14,JALISCO,14,TLAJOMULCO DE ZUÐIGA,98,TLAJOMULCO DE ZUÐIGA,3409,665,659,0,1324,660,652,0,1312
14,JALISCO,14,TLAJOMULCO DE ZUÐIGA,98,TLAJOMULCO DE ZUÐIGA,3410,850,920,0,1770,843,908,0,1751
14,JALISCO,14,TLAJOMULCO DE ZUÐIGA,98,TLAJOMULCO DE ZUÐIGA,3411,1899,2021,0,3920,1873,2006,0,3879
14,JALISCO,14,TLAJOMULCO DE ZUÐIGA,98,TLAJOMULCO DE ZUÐIGA,3412,1549,1665,0,3214,1537,1655,0,3192
14,JALISCO,14,TLAJOMULCO DE ZUÐIGA,98,TLAJOMULCO DE ZUÐIGA,3414,1465,1546,0,3011,1448,1537,0,2985
14,JALISCO,14,TLAJOMULCO DE ZUÐIGA,98,TLAJOMULCO DE ZUÐIGA,3415,5020,5107,0,10127,4942,5063,0,10005
14,JALISCO,14,TLAJOMULCO DE ZUÐIGA,98,TLAJOMULCO DE ZUÐIGA,3416,4832,4956,0,9788,4761,4908,0,9669
14,JALISCO,14,TLAJOMULCO DE ZUÐIGA,98,TLAJOMULCO DE ZUÐIGA,3417,703,782,0,1485,695,778,0,1473
14,JALISCO,14,TLAJOMULCO DE ZUÐIGA,98,TLAJOMULCO DE ZUÐIGA,3418,1115,1163,0,2278,1109,1154,0,2263
14,JALISCO,14,TLAJOMULCO DE ZUÐIGA,98,TLAJOMULCO DE ZUÐIGA,3419,1096,1271,0,2367,1085,1263,0,2348
14,JALISCO,14,TLAJOMULCO DE ZUÐIGA,98,TLAJOMULCO DE ZUÐIGA,3420,1902,1880,0,3782,1889,1868,0,3757
14,JALISCO,14,TLAJOMULCO DE ZUÐIGA,98,TLAJOMULCO DE ZUÐIGA,3421,3958,4109,0,8067,3916,4069,0,7985
14,JALISCO,14,TLAJOMULCO DE ZUÐIGA,98,TLAJOMULCO DE ZUÐIGA,3422,1287,1385,0,2672,1270,1368,0,2638
14,JALISCO,14,TLAJOMULCO DE ZUÐIGA,98,TLAJOMULCO DE ZUÐIGA,3423,783,801,0,1584,774,790,0,1564
14,JALISCO,14,TLAJOMULCO DE ZUÐIGA,98,TLAJOMULCO DE ZUÐIGA,3424,1295,1341,0,2636,1283,1327,0,2610
14,JALISCO,14,TLAJOMULCO DE ZUÐIGA,98,TLAJOMULCO DE ZUÐIGA,3425,3683,3777,0,7460,3634,3739,0,7373
14,JALISCO,14,TLAJOMULCO DE ZUÐIGA,98,TLAJOMULCO DE ZUÐIGA,3426,159,148,0,307,156,148,0,304
14,JALISCO,14,TLAJOMULCO DE ZUÐIGA,98,TLAJOMULCO DE ZUÐIGA,3427,434,483,0,917,430,480,0,910
14,JALISCO,14,TLAJOMULCO DE ZUÐIGA,98,TLAJOMULCO DE ZUÐIGA,3428,1303,1303,0,2606,1297,1287,0,2584
14,JALISCO,14,TLAJOMULCO DE ZUÐIGA,98,TLAJOMULCO DE ZUÐIGA,3429,2718,2815,0,5533,2687,2787,0,5474
14,JALISCO,14,TLAJOMULCO DE ZUÐIGA,98,TLAJOMULCO DE ZUÐIGA,3430,566,566,0,1132,558,565,0,1123
14,JALISCO,14,TLAJOMULCO DE ZUÐIGA,98,TLAJOMULCO DE ZUÐIGA,3431,538,537,0,1075,528,535,0,1063
14,JALISCO,14,TLAJOMULCO DE ZUÐIGA,98,TLAJOMULCO DE ZUÐIGA,3432,363,353,0,716,358,347,0,705
14,JALISCO,14,TLAJOMULCO DE ZUÐIGA,98,TLAJOMULCO DE ZUÐIGA,3433,733,709,0,1442,725,699,0,1424
14,JALISCO,14,TLAJOMULCO DE ZUÐIGA,98,TLAJOMULCO DE ZUÐIGA,3434,719,718,0,1437,714,710,0,1424
14,JALISCO,14,TLAJOMULCO DE ZUÐIGA,98,TLAJOMULCO DE ZUÐIGA,3435,1108,1152,0,2260,1101,1142,0,2243
14,JALISCO,14,TLAJOMULCO DE ZUÐIGA,98,TLAJOMULCO DE ZUÐIGA,3436,1236,1360,0,2596,1229,1352,0,2581
14,JALISCO,14,TLAJOMULCO DE ZUÐIGA,98,TLAJOMULCO DE ZUÐIGA,3437,3667,3719,0,7386,3630,3691,0,7321
14,JALISCO,14,TLAJOMULCO DE ZUÐIGA,98,TLAJOMULCO DE ZUÐIGA,3438,1200,1285,0,2485,1192,1276,0,2468
14,JALISCO,14,TLAJOMULCO DE ZUÐIGA,98,TLAJOMULCO DE ZUÐIGA,3439,1661,1723,0,3384,1645,1708,0,3353
14,JALISCO,14,TLAJOMULCO DE ZUÐIGA,98,TLAJOMULCO DE ZUÐIGA,3440,1952,2206,0,4158,1929,2191,0,4120
14,JALISCO,14,TLAJOMULCO DE ZUÐIGA,98,TLAJOMULCO DE ZUÐIGA,3441,1324,1357,0,2681,1310,1344,0,2654
14,JALISCO,14,TLAJOMULCO DE ZUÐIGA,98,TLAJOMULCO DE ZUÐIGA,3442,1685,1786,0,3471,1671,1781,0,3452
14,JALISCO,14,TLAJOMULCO DE ZUÐIGA,98,TLAJOMULCO DE ZUÐIGA,3443,431,445,0,876,426,442,0,868
14,JALISCO,14,TLAJOMULCO DE ZUÐIGA,98,TLAJOMULCO DE ZUÐIGA,3448,187,170,0,357,186,170,0,356
14,JALISCO,14,TLAJOMULCO DE ZUÐIGA,98,TLAJOMULCO DE ZUÐIGA,3449,268,305,0,573,267,301,0,568
14,JALISCO,14,TLAJOMULCO DE ZUÐIGA,98,TLAJOMULCO DE ZUÐIGA,3450,383,383,0,766,379,377,0,756
14,JALISCO,14,TLAJOMULCO DE ZUÐIGA,98,TLAJOMULCO DE ZUÐIGA,3451,2688,2732,0,5420,2653,2706,0,5359
14,JALISCO,14,TLAJOMULCO DE ZUÐIGA,98,TLAJOMULCO DE ZUÐIGA,3452,1760,1784,0,3544,1728,1747,0,3475
14,JALISCO,14,TLAJOMULCO DE ZUÐIGA,98,TLAJOMULCO DE ZUÐIGA,3454,1009,1068,0,2077,1003,1063,0,2066
14,JALISCO,14,TLAJOMULCO DE ZUÐIGA,98,TLAJOMULCO DE ZUÐIGA,3455,1645,1706,0,3351,1630,1690,0,3320
14,JALISCO,14,TLAJOMULCO DE ZUÐIGA,98,TLAJOMULCO DE ZUÐIGA,3456,743,766,0,1509,741,757,0,1498
14,JALISCO,14,TLAJOMULCO DE ZUÐIGA,98,TLAJOMULCO DE ZUÐIGA,3457,589,594,0,1183,587,591,0,1178
14,JALISCO,14,TLAJOMULCO DE ZUÐIGA,98,TLAJOMULCO DE ZUÐIGA,3458,425,456,0,881,422,453,0,875
14,JALISCO,14,TLAJOMULCO DE ZUÐIGA,98,TLAJOMULCO DE ZUÐIGA,3591,695,618,0,1313,692,617,0,1309
14,JALISCO,14,TLAJOMULCO DE ZUÐIGA,98,TLAJOMULCO DE ZUÐIGA,3592,1818,1604,0,3422,1791,1578,0,3369
14,JALISCO,14,TLAJOMULCO DE ZUÐIGA,98,TLAJOMULCO DE ZUÐIGA,3593,784,855,0,1639,774,850,0,1624
14,JALISCO,14,TLAJOMULCO DE ZUÐIGA,98,TLAJOMULCO DE ZUÐIGA,3594,781,861,0,1642,775,853,0,1628
14,JALISCO,14,TLAJOMULCO DE ZUÐIGA,98,TLAJOMULCO DE ZUÐIGA,3595,1261,1336,0,2597,1248,1327,0,2575
14,JALISCO,14,TLAJOMULCO DE ZUÐIGA,98,TLAJOMULCO DE ZUÐIGA,3596,597,652,0,1249,597,652,0,1249
14,JALISCO,14,TLAJOMULCO DE ZUÐIGA,98,TLAJOMULCO DE ZUÐIGA,3597,920,989,0,1909,914,981,0,1895
14,JALISCO,14,TLAJOMULCO DE ZUÐIGA,98,TLAJOMULCO DE ZUÐIGA,3598,1711,1875,0,3586,1695,1862,0,3557
14,JALISCO,14,TLAJOMULCO DE ZUÐIGA,98,TLAJOMULCO DE ZUÐIGA,3599,1850,1897,0,3747,1835,1880,0,3715
14,JALISCO,14,TLAJOMULCO DE ZUÐIGA,98,TLAJOMULCO DE ZUÐIGA,3600,1359,1394,0,2753,1346,1382,0,2728
14,JALISCO,14,TLAJOMULCO DE ZUÐIGA,98,TLAJOMULCO DE ZUÐIGA,3601,1744,1859,0,3603,1722,1835,0,3557
14,JALISCO,14,TLAJOMULCO DE ZUÐIGA,98,TLAJOMULCO DE ZUÐIGA,3658,1068,1106,0,2174,1052,1091,0,2143
14,JALISCO,14,TLAJOMULCO DE ZUÐIGA,98,TLAJOMULCO DE ZUÐIGA,3659,938,991,0,1929,894,960,0,1854
14,JALISCO,14,TLAJOMULCO DE ZUÐIGA,98,TLAJOMULCO DE ZUÐIGA,3815,297,281,0,578,293,278,0,571
14,JALISCO,14,TLAJOMULCO DE ZUÐIGA,98,TLAJOMULCO DE ZUÐIGA,3816,701,702,0,1403,696,700,0,1396
14,JALISCO,14,TLAJOMULCO DE ZUÐIGA,98,TLAJOMULCO DE ZUÐIGA,3817,273,269,0,542,273,267,0,540
14,JALISCO,14,TLAJOMULCO DE ZUÐIGA,98,TLAJOMULCO DE ZUÐIGA,3818,374,354,0,728,371,349,0,720
14,JALISCO,14,TLAJOMULCO DE ZUÐIGA,98,TLAJOMULCO DE ZUÐIGA,3819,147,161,0,308,146,161,0,307
14,JALISCO,14,TLAJOMULCO DE ZUÐIGA,98,TLAJOMULCO DE ZUÐIGA,3820,722,738,0,1460,711,734,0,1445
14,JALISCO,14,TLAJOMULCO DE ZUÐIGA,98,TLAJOMULCO DE ZUÐIGA,3821,726,766,0,1492,718,760,0,1478
14,JALISCO,14,TLAJOMULCO DE ZUÐIGA,98,TLAJOMULCO DE ZUÐIGA,3822,1160,1114,0,2274,1139,1106,0,2245
14,JALISCO,14,TLAJOMULCO DE ZUÐIGA,98,TLAJOMULCO DE ZUÐIGA,3823,1507,1639,0,3146,1495,1629,0,3124
14,JALISCO,14,TLAJOMULCO DE ZUÐIGA,98,TLAJOMULCO DE ZUÐIGA,3824,1777,1924,0,3701,1760,1905,0,3665
14,JALISCO,14,TLAJOMULCO DE ZUÐIGA,98,TLAJOMULCO DE ZUÐIGA,3825,1612,1645,1,3258,1587,1635,1,3223
14,JALISCO,14,TLAJOMULCO DE ZUÐIGA,98,TLAJOMULCO DE ZUÐIGA,3972,1447,1438,0,2885,1427,1417,0,2844
14,JALISCO,14,TLAJOMULCO DE ZUÐIGA,98,TLAJOMULCO DE ZUÐIGA,3973,989,1021,0,2010,984,1011,0,1995
14,JALISCO,14,TLAJOMULCO DE ZUÐIGA,98,TLAJOMULCO DE ZUÐIGA,3974,641,643,0,1284,638,640,0,1278
14,JALISCO,14,TLAJOMULCO DE ZUÐIGA,98,TLAJOMULCO DE ZUÐIGA,3975,653,714,0,1367,645,709,0,1354
14,JALISCO,14,TLAJOMULCO DE ZUÐIGA,98,TLAJOMULCO DE ZUÐIGA,3976,899,994,0,1893,888,979,0,1867
14,JALISCO,14,TLAJOMULCO DE ZUÐIGA,98,TLAJOMULCO DE ZUÐIGA,3977,1306,1424,0,2730,1292,1404,0,2696
14,JALISCO,14,TLAJOMULCO DE ZUÐIGA,98,TLAJOMULCO DE ZUÐIGA,3978,898,1098,0,1996,892,1084,0,1976
14,JALISCO,15,LA BARCA,8,ARANDAS,102,1407,1496,0,2903,1400,1487,0,2887
14,JALISCO,15,LA BARCA,8,ARANDAS,103,763,853,0,1616,760,848,0,1608
14,JALISCO,15,LA BARCA,8,ARANDAS,104,1123,1289,0,2412,1112,1285,0,2397
14,JALISCO,15,LA BARCA,8,ARANDAS,105,709,773,0,1482,705,770,0,1475
14,JALISCO,15,LA BARCA,8,ARANDAS,106,2497,2722,0,5219,2476,2712,0,5188
14,JALISCO,15,LA BARCA,8,ARANDAS,107,4186,4440,0,8626,4152,4408,0,8560
14,JALISCO,15,LA BARCA,8,ARANDAS,108,650,769,0,1419,642,764,0,1406
14,JALISCO,15,LA BARCA,8,ARANDAS,109,442,500,0,942,437,493,0,930
14,JALISCO,15,LA BARCA,8,ARANDAS,110,494,565,0,1059,490,559,0,1049
14,JALISCO,15,LA BARCA,8,ARANDAS,111,1857,2035,0,3892,1846,2018,0,3864
14,JALISCO,15,LA BARCA,8,ARANDAS,112,1262,1347,0,2609,1254,1336,0,2590
14,JALISCO,15,LA BARCA,8,ARANDAS,113,653,723,0,1376,644,717,0,1361
14,JALISCO,15,LA BARCA,8,ARANDAS,114,1688,1806,0,3494,1673,1789,0,3462
14,JALISCO,15,LA BARCA,8,ARANDAS,115,1836,1901,0,3737,1820,1878,0,3698
14,JALISCO,15,LA BARCA,8,ARANDAS,116,1722,1860,0,3582,1698,1840,0,3538
14,JALISCO,15,LA BARCA,8,ARANDAS,117,3071,3342,0,6413,3053,3323,0,6376
14,JALISCO,15,LA BARCA,8,ARANDAS,118,770,817,0,1587,767,816,0,1583
14,JALISCO,15,LA BARCA,8,ARANDAS,119,780,867,0,1647,773,862,0,1635
14,JALISCO,15,LA BARCA,8,ARANDAS,124,414,422,0,836,413,419,0,832
14,JALISCO,15,LA BARCA,8,ARANDAS,125,313,308,0,621,312,306,0,618
14,JALISCO,15,LA BARCA,8,ARANDAS,126,149,179,0,328,146,175,0,321
14,JALISCO,15,LA BARCA,8,ARANDAS,127,702,814,0,1516,697,808,0,1505
14,JALISCO,15,LA BARCA,8,ARANDAS,128,183,209,0,392,183,208,0,391
14,JALISCO,15,LA BARCA,8,ARANDAS,129,57,86,0,143,57,86,0,143
14,JALISCO,15,LA BARCA,8,ARANDAS,130,172,155,0,327,171,155,0,326
14,JALISCO,15,LA BARCA,8,ARANDAS,131,354,346,0,700,350,344,0,694
14,JALISCO,15,LA BARCA,8,ARANDAS,132,529,488,0,1017,525,485,0,1010
14,JALISCO,15,LA BARCA,8,ARANDAS,133,719,690,0,1409,710,683,0,1393
14,JALISCO,15,LA BARCA,8,ARANDAS,134,824,807,0,1631,815,800,0,1615
14,JALISCO,15,LA BARCA,8,ARANDAS,137,579,573,0,1152,573,567,0,1140
14,JALISCO,15,LA BARCA,13,ATOTONILCO EL ALTO,161,1227,1335,0,2562,1212,1327,0,2539
14,JALISCO,15,LA BARCA,13,ATOTONILCO EL ALTO,162,341,407,0,748,338,404,0,742
14,JALISCO,15,LA BARCA,13,ATOTONILCO EL ALTO,163,683,750,0,1433,678,749,0,1427
14,JALISCO,15,LA BARCA,13,ATOTONILCO EL ALTO,164,1607,1556,0,3163,1594,1539,0,3133
14,JALISCO,15,LA BARCA,13,ATOTONILCO EL ALTO,165,397,463,0,860,396,460,0,856
14,JALISCO,15,LA BARCA,13,ATOTONILCO EL ALTO,166,1338,1389,0,2727,1328,1374,0,2702
14,JALISCO,15,LA BARCA,13,ATOTONILCO EL ALTO,167,1774,1786,0,3560,1759,1771,0,3530
14,JALISCO,15,LA BARCA,13,ATOTONILCO EL ALTO,168,594,682,0,1276,588,674,0,1262
14,JALISCO,15,LA BARCA,13,ATOTONILCO EL ALTO,169,546,598,0,1144,543,594,0,1137
14,JALISCO,15,LA BARCA,13,ATOTONILCO EL ALTO,171,1417,1542,0,2959,1404,1524,0,2928
14,JALISCO,15,LA BARCA,13,ATOTONILCO EL ALTO,172,1358,1464,0,2822,1339,1451,0,2790
14,JALISCO,15,LA BARCA,13,ATOTONILCO EL ALTO,173,1087,1111,0,2198,1073,1099,0,2172
14,JALISCO,15,LA BARCA,13,ATOTONILCO EL ALTO,174,455,478,0,933,453,477,0,930
14,JALISCO,15,LA BARCA,13,ATOTONILCO EL ALTO,175,518,564,0,1082,515,557,0,1072
14,JALISCO,15,LA BARCA,13,ATOTONILCO EL ALTO,176,1292,1411,0,2703,1267,1393,0,2660
14,JALISCO,15,LA BARCA,13,ATOTONILCO EL ALTO,177,1265,1360,0,2625,1243,1339,0,2582
14,JALISCO,15,LA BARCA,13,ATOTONILCO EL ALTO,178,53,59,0,112,53,59,0,112
14,JALISCO,15,LA BARCA,13,ATOTONILCO EL ALTO,179,288,289,0,577,285,285,0,570
14,JALISCO,15,LA BARCA,13,ATOTONILCO EL ALTO,180,574,573,0,1147,570,567,0,1137
14,JALISCO,15,LA BARCA,13,ATOTONILCO EL ALTO,181,901,935,0,1836,890,924,0,1814
14,JALISCO,15,LA BARCA,13,ATOTONILCO EL ALTO,182,876,917,0,1793,864,911,0,1775
14,JALISCO,15,LA BARCA,13,ATOTONILCO EL ALTO,183,450,485,0,935,442,478,0,920
14,JALISCO,15,LA BARCA,13,ATOTONILCO EL ALTO,184,1232,1272,0,2504,1226,1263,0,2489
14,JALISCO,15,LA BARCA,13,ATOTONILCO EL ALTO,185,782,838,0,1620,771,830,0,1601
14,JALISCO,15,LA BARCA,13,ATOTONILCO EL ALTO,186,709,692,0,1401,702,687,0,1389
14,JALISCO,15,LA BARCA,13,ATOTONILCO EL ALTO,187,761,798,0,1559,754,793,0,1547
14,JALISCO,15,LA BARCA,13,ATOTONILCO EL ALTO,3681,458,483,0,941,456,478,0,934
14,JALISCO,15,LA BARCA,13,ATOTONILCO EL ALTO,3832,1040,1099,0,2139,1029,1093,0,2122
14,JALISCO,15,LA BARCA,13,ATOTONILCO EL ALTO,3833,363,391,0,754,362,387,0,749
14,JALISCO,15,LA BARCA,13,ATOTONILCO EL ALTO,3834,1037,1175,0,2212,1025,1167,0,2192
14,JALISCO,15,LA BARCA,16,AYOTLAN,224,1360,1529,0,2889,1327,1498,0,2825
14,JALISCO,15,LA BARCA,16,AYOTLAN,225,1959,2092,0,4051,1911,2053,0,3964
14,JALISCO,15,LA BARCA,16,AYOTLAN,226,1132,1220,0,2352,1118,1196,0,2314
14,JALISCO,15,LA BARCA,16,AYOTLAN,227,1338,1520,0,2858,1308,1487,0,2795
14,JALISCO,15,LA BARCA,16,AYOTLAN,228,726,859,0,1585,717,838,0,1555
14,JALISCO,15,LA BARCA,16,AYOTLAN,229,646,631,0,1277,635,628,0,1263
14,JALISCO,15,LA BARCA,16,AYOTLAN,230,1025,1122,0,2147,1013,1084,0,2097
14,JALISCO,15,LA BARCA,16,AYOTLAN,231,598,704,0,1302,591,673,0,1264
14,JALISCO,15,LA BARCA,16,AYOTLAN,232,1351,1510,0,2861,1309,1477,0,2786
14,JALISCO,15,LA BARCA,16,AYOTLAN,233,1443,1572,0,3015,1432,1552,0,2984
14,JALISCO,15,LA BARCA,16,AYOTLAN,235,96,90,0,186,93,88,0,181
14,JALISCO,15,LA BARCA,16,AYOTLAN,236,455,439,0,894,442,427,0,869
14,JALISCO,15,LA BARCA,16,AYOTLAN,237,125,125,0,250,125,123,0,248
14,JALISCO,15,LA BARCA,16,AYOTLAN,238,447,470,0,917,440,464,0,904
14,JALISCO,15,LA BARCA,16,AYOTLAN,239,256,282,0,538,252,277,0,529
14,JALISCO,15,LA BARCA,16,AYOTLAN,240,357,367,0,724,348,364,0,712
14,JALISCO,15,LA BARCA,16,AYOTLAN,241,358,381,0,739,350,376,0,726
14,JALISCO,15,LA BARCA,16,AYOTLAN,242,595,609,0,1204,586,596,0,1182
14,JALISCO,15,LA BARCA,16,AYOTLAN,243,1135,1186,0,2321,1117,1154,0,2271
14,JALISCO,15,LA BARCA,18,LA BARCA,256,1517,1681,0,3198,1503,1667,0,3170
14,JALISCO,15,LA BARCA,18,LA BARCA,257,1861,1975,0,3836,1847,1948,0,3795
14,JALISCO,15,LA BARCA,18,LA BARCA,258,2794,3047,0,5841,2767,3013,0,5780
14,JALISCO,15,LA BARCA,18,LA BARCA,259,1129,1249,0,2378,1120,1237,0,2357
14,JALISCO,15,LA BARCA,18,LA BARCA,260,1402,1487,0,2889,1384,1479,0,2863
14,JALISCO,15,LA BARCA,18,LA BARCA,261,930,980,0,1910,922,972,0,1894
14,JALISCO,15,LA BARCA,18,LA BARCA,262,925,1010,0,1935,915,1001,0,1916
14,JALISCO,15,LA BARCA,18,LA BARCA,263,1099,1280,0,2379,1086,1271,0,2357
14,JALISCO,15,LA BARCA,18,LA BARCA,264,619,804,0,1423,616,796,0,1412
14,JALISCO,15,LA BARCA,18,LA BARCA,265,782,883,0,1665,777,875,0,1652
14,JALISCO,15,LA BARCA,18,LA BARCA,266,343,436,0,779,340,430,0,770
14,JALISCO,15,LA BARCA,18,LA BARCA,267,689,832,0,1521,684,825,0,1509
14,JALISCO,15,LA BARCA,18,LA BARCA,268,447,588,0,1035,447,583,0,1030
14,JALISCO,15,LA BARCA,18,LA BARCA,269,1416,1522,0,2938,1403,1512,0,2915
14,JALISCO,15,LA BARCA,18,LA BARCA,270,711,697,0,1408,704,692,0,1396
14,JALISCO,15,LA BARCA,18,LA BARCA,271,576,651,0,1227,573,649,0,1222
14,JALISCO,15,LA BARCA,18,LA BARCA,272,324,350,0,674,322,349,0,671
14,JALISCO,15,LA BARCA,18,LA BARCA,273,784,865,0,1649,780,860,0,1640
14,JALISCO,15,LA BARCA,18,LA BARCA,274,551,571,0,1122,546,562,0,1108
14,JALISCO,15,LA BARCA,18,LA BARCA,275,512,505,0,1017,508,497,0,1005
14,JALISCO,15,LA BARCA,18,LA BARCA,276,379,365,0,744,377,363,0,740
14,JALISCO,15,LA BARCA,18,LA BARCA,277,318,330,0,648,315,328,0,643
14,JALISCO,15,LA BARCA,18,LA BARCA,278,510,544,0,1054,505,539,0,1044
14,JALISCO,15,LA BARCA,18,LA BARCA,279,417,436,0,853,410,431,0,841
14,JALISCO,15,LA BARCA,18,LA BARCA,280,594,593,0,1187,588,584,0,1172
14,JALISCO,15,LA BARCA,18,LA BARCA,281,511,541,0,1052,506,530,0,1036
14,JALISCO,15,LA BARCA,18,LA BARCA,282,412,456,0,868,408,450,0,858
14,JALISCO,15,LA BARCA,18,LA BARCA,283,1095,1083,0,2178,1079,1070,0,2149
14,JALISCO,15,LA BARCA,18,LA BARCA,284,236,264,0,500,234,261,0,495
14,JALISCO,15,LA BARCA,18,LA BARCA,285,701,716,0,1417,697,709,0,1406
14,JALISCO,15,LA BARCA,18,LA BARCA,286,197,227,0,424,194,225,0,419
14,JALISCO,15,LA BARCA,18,LA BARCA,287,1006,1022,0,2028,999,1011,0,2010
14,JALISCO,15,LA BARCA,18,LA BARCA,288,840,929,0,1769,830,924,0,1754
14,JALISCO,15,LA BARCA,18,LA BARCA,289,506,543,0,1049,503,539,0,1042
14,JALISCO,15,LA BARCA,18,LA BARCA,290,886,1054,0,1940,872,1039,0,1911
14,JALISCO,15,LA BARCA,18,LA BARCA,291,460,520,0,980,457,516,0,973
14,JALISCO,15,LA BARCA,34,DEGOLLADO,483,1748,2036,0,3784,1726,2015,0,3741
14,JALISCO,15,LA BARCA,34,DEGOLLADO,484,710,837,0,1547,700,823,0,1523
14,JALISCO,15,LA BARCA,34,DEGOLLADO,485,505,582,0,1087,497,577,0,1074
14,JALISCO,15,LA BARCA,34,DEGOLLADO,486,429,485,0,914,424,483,0,907
14,JALISCO,15,LA BARCA,34,DEGOLLADO,487,823,841,0,1664,812,826,0,1638
14,JALISCO,15,LA BARCA,34,DEGOLLADO,488,990,1105,0,2095,978,1094,0,2072
14,JALISCO,15,LA BARCA,34,DEGOLLADO,489,801,795,0,1596,794,785,0,1579
14,JALISCO,15,LA BARCA,34,DEGOLLADO,490,479,478,0,957,473,476,0,949
14,JALISCO,15,LA BARCA,34,DEGOLLADO,491,341,374,0,715,337,371,0,708
14,JALISCO,15,LA BARCA,34,DEGOLLADO,492,77,73,0,150,76,72,0,148
14,JALISCO,15,LA BARCA,34,DEGOLLADO,493,377,397,0,774,374,391,0,765
14,JALISCO,15,LA BARCA,34,DEGOLLADO,494,138,142,0,280,136,140,0,276
14,JALISCO,15,LA BARCA,34,DEGOLLADO,495,510,462,0,972,502,457,0,959
14,JALISCO,15,LA BARCA,34,DEGOLLADO,496,545,547,0,1092,541,541,0,1082
14,JALISCO,15,LA BARCA,34,DEGOLLADO,497,388,399,0,787,386,397,0,783
14,JALISCO,15,LA BARCA,34,DEGOLLADO,498,366,385,0,751,363,383,0,746
14,JALISCO,15,LA BARCA,48,JALOSTOTITLAN,1613,1423,1551,0,2974,1400,1530,0,2930
14,JALISCO,15,LA BARCA,48,JALOSTOTITLAN,1614,651,699,0,1350,639,692,0,1331
14,JALISCO,15,LA BARCA,48,JALOSTOTITLAN,1615,1365,1379,0,2744,1355,1365,0,2720
14,JALISCO,15,LA BARCA,48,JALOSTOTITLAN,1616,722,779,0,1501,715,767,0,1482
14,JALISCO,15,LA BARCA,48,JALOSTOTITLAN,1617,458,505,0,963,446,497,0,943
14,JALISCO,15,LA BARCA,48,JALOSTOTITLAN,1618,394,443,0,837,385,436,0,821
14,JALISCO,15,LA BARCA,48,JALOSTOTITLAN,1619,768,789,0,1557,761,781,0,1542
14,JALISCO,15,LA BARCA,48,JALOSTOTITLAN,1620,1687,1895,0,3582,1660,1871,0,3531
14,JALISCO,15,LA BARCA,48,JALOSTOTITLAN,1621,507,567,0,1074,498,560,0,1058
14,JALISCO,15,LA BARCA,48,JALOSTOTITLAN,1622,1463,1571,0,3034,1439,1553,0,2992
14,JALISCO,15,LA BARCA,48,JALOSTOTITLAN,1623,781,838,0,1619,768,823,0,1591
14,JALISCO,15,LA BARCA,48,JALOSTOTITLAN,1624,1001,1106,0,2107,985,1095,0,2080
14,JALISCO,15,LA BARCA,48,JALOSTOTITLAN,1625,156,183,0,339,153,178,0,331
14,JALISCO,15,LA BARCA,48,JALOSTOTITLAN,1626,514,614,0,1128,508,606,0,1114
14,JALISCO,15,LA BARCA,48,JALOSTOTITLAN,1627,51,50,0,101,51,50,0,101
14,JALISCO,15,LA BARCA,48,JALOSTOTITLAN,1628,388,394,0,782,385,392,0,777
14,JALISCO,15,LA BARCA,48,JALOSTOTITLAN,1629,190,193,0,383,188,192,0,380
14,JALISCO,15,LA BARCA,48,JALOSTOTITLAN,1630,76,88,0,164,75,88,0,163
14,JALISCO,15,LA BARCA,48,JALOSTOTITLAN,1631,269,276,0,545,266,274,0,540
14,JALISCO,15,LA BARCA,48,JALOSTOTITLAN,1632,82,77,0,159,82,77,0,159
14,JALISCO,15,LA BARCA,48,JALOSTOTITLAN,1633,747,790,0,1537,739,780,0,1519
14,JALISCO,15,LA BARCA,48,JALOSTOTITLAN,1634,92,84,0,176,91,84,0,175
14,JALISCO,15,LA BARCA,49,JAMAY,1635,1669,1746,0,3415,1661,1734,0,3395
14,JALISCO,15,LA BARCA,49,JAMAY,1636,1377,1502,0,2879,1364,1491,0,2855
14,JALISCO,15,LA BARCA,49,JAMAY,1637,829,865,0,1694,821,853,0,1674
14,JALISCO,15,LA BARCA,49,JAMAY,1638,1209,1206,0,2415,1203,1201,0,2404
14,JALISCO,15,LA BARCA,49,JAMAY,1639,757,794,0,1551,756,789,0,1545
14,JALISCO,15,LA BARCA,49,JAMAY,1640,323,310,0,633,320,308,0,628
14,JALISCO,15,LA BARCA,49,JAMAY,1641,764,791,0,1555,753,775,0,1528
14,JALISCO,15,LA BARCA,49,JAMAY,1642,578,649,0,1227,571,641,0,1212
14,JALISCO,15,LA BARCA,49,JAMAY,1643,1230,1308,0,2538,1219,1301,0,2520
14,JALISCO,15,LA BARCA,49,JAMAY,1644,970,1079,0,2049,962,1076,0,2038
14,JALISCO,15,LA BARCA,49,JAMAY,1645,62,32,0,94,61,32,0,93
14,JALISCO,15,LA BARCA,49,JAMAY,1646,251,257,0,508,251,257,0,508
14,JALISCO,15,LA BARCA,50,JESUS MARIA,1647,654,764,0,1418,646,755,0,1401
14,JALISCO,15,LA BARCA,50,JESUS MARIA,1648,761,851,0,1612,754,846,0,1600
14,JALISCO,15,LA BARCA,50,JESUS MARIA,1649,1147,1287,0,2434,1142,1274,0,2416
14,JALISCO,15,LA BARCA,50,JESUS MARIA,1650,855,989,0,1844,844,973,0,1817
14,JALISCO,15,LA BARCA,50,JESUS MARIA,1651,1026,1175,0,2201,1017,1167,0,2184
14,JALISCO,15,LA BARCA,50,JESUS MARIA,1652,123,110,0,233,123,110,0,233
14,JALISCO,15,LA BARCA,50,JESUS MARIA,1653,401,441,0,842,399,438,0,837
14,JALISCO,15,LA BARCA,50,JESUS MARIA,1654,355,371,0,726,353,370,0,723
14,JALISCO,15,LA BARCA,50,JESUS MARIA,1655,953,990,0,1943,946,978,0,1924
14,JALISCO,15,LA BARCA,50,JESUS MARIA,1656,259,213,0,472,258,212,0,470
14,JALISCO,15,LA BARCA,50,JESUS MARIA,1657,260,254,0,514,257,253,0,510
14,JALISCO,15,LA BARCA,50,JESUS MARIA,1658,541,591,0,1132,540,589,0,1129
14,JALISCO,15,LA BARCA,50,JESUS MARIA,1659,362,425,0,787,357,418,0,775
14,JALISCO,15,LA BARCA,50,JESUS MARIA,1660,565,621,0,1186,557,612,0,1169
14,JALISCO,15,LA BARCA,74,SAN DIEGO DE ALEJANDRIA,2056,668,736,0,1404,664,727,0,1391
14,JALISCO,15,LA BARCA,74,SAN DIEGO DE ALEJANDRIA,2057,227,239,0,466,226,235,0,461
14,JALISCO,15,LA BARCA,74,SAN DIEGO DE ALEJANDRIA,2058,119,115,0,234,119,114,0,233
14,JALISCO,15,LA BARCA,74,SAN DIEGO DE ALEJANDRIA,2060,76,62,0,138,76,62,0,138
14,JALISCO,15,LA BARCA,74,SAN DIEGO DE ALEJANDRIA,2061,60,78,0,138,59,77,0,136
14,JALISCO,15,LA BARCA,74,SAN DIEGO DE ALEJANDRIA,2062,76,73,0,149,76,73,0,149
14,JALISCO,15,LA BARCA,74,SAN DIEGO DE ALEJANDRIA,3882,1401,1533,0,2934,1390,1528,0,2918
14,JALISCO,15,LA BARCA,74,SAN DIEGO DE ALEJANDRIA,3883,134,136,0,270,133,136,0,269
14,JALISCO,15,LA BARCA,76,SAN JULIAN,2097,319,348,0,667,317,341,0,658
14,JALISCO,15,LA BARCA,76,SAN JULIAN,2098,1464,1625,0,3089,1449,1615,0,3064
14,JALISCO,15,LA BARCA,76,SAN JULIAN,2099,1081,1284,0,2365,1074,1273,0,2347
14,JALISCO,15,LA BARCA,76,SAN JULIAN,2100,725,767,0,1492,717,764,0,1481
14,JALISCO,15,LA BARCA,76,SAN JULIAN,2101,1076,1217,0,2293,1066,1208,0,2274
14,JALISCO,15,LA BARCA,76,SAN JULIAN,2102,650,822,0,1472,650,821,0,1471
14,JALISCO,15,LA BARCA,76,SAN JULIAN,2103,843,966,0,1809,829,957,0,1786
14,JALISCO,15,LA BARCA,76,SAN JULIAN,2104,77,72,0,149,75,72,0,147
14,JALISCO,15,LA BARCA,76,SAN JULIAN,2105,227,243,0,470,226,243,0,469
14,JALISCO,15,LA BARCA,80,SAN MIGUEL EL ALTO,2132,922,1055,0,1977,915,1041,0,1956
14,JALISCO,15,LA BARCA,80,SAN MIGUEL EL ALTO,2133,1917,2023,0,3940,1888,2000,0,3888
14,JALISCO,15,LA BARCA,80,SAN MIGUEL EL ALTO,2134,807,846,0,1653,789,836,0,1625
14,JALISCO,15,LA BARCA,80,SAN MIGUEL EL ALTO,2135,825,916,0,1741,809,898,0,1707
14,JALISCO,15,LA BARCA,80,SAN MIGUEL EL ALTO,2136,873,959,0,1832,862,946,0,1808
14,JALISCO,15,LA BARCA,80,SAN MIGUEL EL ALTO,2137,725,829,0,1554,717,812,0,1529
14,JALISCO,15,LA BARCA,80,SAN MIGUEL EL ALTO,2138,1394,1558,0,2952,1373,1541,0,2914
14,JALISCO,15,LA BARCA,80,SAN MIGUEL EL ALTO,2139,1033,1134,0,2167,1021,1122,0,2143
14,JALISCO,15,LA BARCA,80,SAN MIGUEL EL ALTO,2141,83,82,0,165,82,82,0,164
14,JALISCO,15,LA BARCA,80,SAN MIGUEL EL ALTO,2142,569,629,0,1198,567,626,0,1193
14,JALISCO,15,LA BARCA,80,SAN MIGUEL EL ALTO,2144,301,299,0,600,299,298,0,597
14,JALISCO,15,LA BARCA,80,SAN MIGUEL EL ALTO,2145,179,174,0,353,179,174,0,353
14,JALISCO,15,LA BARCA,80,SAN MIGUEL EL ALTO,2146,86,85,0,171,84,85,0,169
14,JALISCO,15,LA BARCA,80,SAN MIGUEL EL ALTO,2147,390,390,0,780,386,386,0,772
14,JALISCO,15,LA BARCA,80,SAN MIGUEL EL ALTO,2148,165,184,0,349,163,183,0,346
14,JALISCO,15,LA BARCA,80,SAN MIGUEL EL ALTO,2149,581,618,0,1199,579,618,0,1197
14,JALISCO,15,LA BARCA,80,SAN MIGUEL EL ALTO,3764,882,1017,0,1899,867,1001,0,1868
14,JALISCO,15,LA BARCA,80,SAN MIGUEL EL ALTO,3765,931,972,0,1903,915,960,0,1875
14,JALISCO,16,SAN PEDRO TLAQUEPAQUE,99,SAN PEDRO TLAQUEPAQUE,2473,903,1127,0,2030,893,1115,0,2008
14,JALISCO,16,SAN PEDRO TLAQUEPAQUE,99,SAN PEDRO TLAQUEPAQUE,2474,421,460,0,881,417,458,0,875
14,JALISCO,16,SAN PEDRO TLAQUEPAQUE,99,SAN PEDRO TLAQUEPAQUE,2475,437,506,0,943,432,501,0,933
14,JALISCO,16,SAN PEDRO TLAQUEPAQUE,99,SAN PEDRO TLAQUEPAQUE,2476,462,504,0,966,459,497,0,956
14,JALISCO,16,SAN PEDRO TLAQUEPAQUE,99,SAN PEDRO TLAQUEPAQUE,2477,669,717,0,1386,663,716,0,1379
14,JALISCO,16,SAN PEDRO TLAQUEPAQUE,99,SAN PEDRO TLAQUEPAQUE,2478,547,563,0,1110,542,556,0,1098
14,JALISCO,16,SAN PEDRO TLAQUEPAQUE,99,SAN PEDRO TLAQUEPAQUE,2479,411,442,0,853,408,439,0,847
14,JALISCO,16,SAN PEDRO TLAQUEPAQUE,99,SAN PEDRO TLAQUEPAQUE,2480,421,456,0,877,413,453,0,866
14,JALISCO,16,SAN PEDRO TLAQUEPAQUE,99,SAN PEDRO TLAQUEPAQUE,2481,350,403,0,753,346,401,0,747
14,JALISCO,16,SAN PEDRO TLAQUEPAQUE,99,SAN PEDRO TLAQUEPAQUE,2482,879,994,0,1873,875,984,0,1859
14,JALISCO,16,SAN PEDRO TLAQUEPAQUE,99,SAN PEDRO TLAQUEPAQUE,2483,665,788,0,1453,658,782,0,1440
14,JALISCO,16,SAN PEDRO TLAQUEPAQUE,99,SAN PEDRO TLAQUEPAQUE,2484,610,655,0,1265,610,651,0,1261
14,JALISCO,16,SAN PEDRO TLAQUEPAQUE,99,SAN PEDRO TLAQUEPAQUE,2485,584,603,0,1187,579,599,0,1178
14,JALISCO,16,SAN PEDRO TLAQUEPAQUE,99,SAN PEDRO TLAQUEPAQUE,2486,1524,1750,1,3275,1510,1734,1,3245
14,JALISCO,16,SAN PEDRO TLAQUEPAQUE,99,SAN PEDRO TLAQUEPAQUE,2487,1284,1388,0,2672,1274,1380,0,2654
14,JALISCO,16,SAN PEDRO TLAQUEPAQUE,99,SAN PEDRO TLAQUEPAQUE,2488,766,802,0,1568,760,797,0,1557
14,JALISCO,16,SAN PEDRO TLAQUEPAQUE,99,SAN PEDRO TLAQUEPAQUE,2489,477,535,0,1012,474,530,0,1004
14,JALISCO,16,SAN PEDRO TLAQUEPAQUE,99,SAN PEDRO TLAQUEPAQUE,2490,587,670,0,1257,582,664,0,1246
14,JALISCO,16,SAN PEDRO TLAQUEPAQUE,99,SAN PEDRO TLAQUEPAQUE,2491,915,1006,0,1921,904,998,0,1902
14,JALISCO,16,SAN PEDRO TLAQUEPAQUE,99,SAN PEDRO TLAQUEPAQUE,2492,420,446,0,866,418,445,0,863
14,JALISCO,16,SAN PEDRO TLAQUEPAQUE,99,SAN PEDRO TLAQUEPAQUE,2493,210,206,0,416,207,206,0,413
14,JALISCO,16,SAN PEDRO TLAQUEPAQUE,99,SAN PEDRO TLAQUEPAQUE,2494,324,345,0,669,322,344,0,666
14,JALISCO,16,SAN PEDRO TLAQUEPAQUE,99,SAN PEDRO TLAQUEPAQUE,2495,451,498,0,949,448,496,0,944
14,JALISCO,16,SAN PEDRO TLAQUEPAQUE,99,SAN PEDRO TLAQUEPAQUE,2496,469,492,0,961,462,490,0,952
14,JALISCO,16,SAN PEDRO TLAQUEPAQUE,99,SAN PEDRO TLAQUEPAQUE,2497,884,974,0,1858,874,966,0,1840
14,JALISCO,16,SAN PEDRO TLAQUEPAQUE,99,SAN PEDRO TLAQUEPAQUE,2498,458,511,0,969,456,511,0,967
14,JALISCO,16,SAN PEDRO TLAQUEPAQUE,99,SAN PEDRO TLAQUEPAQUE,2499,511,536,0,1047,506,532,0,1038
14,JALISCO,16,SAN PEDRO TLAQUEPAQUE,99,SAN PEDRO TLAQUEPAQUE,2500,679,718,0,1397,677,717,0,1394
14,JALISCO,16,SAN PEDRO TLAQUEPAQUE,99,SAN PEDRO TLAQUEPAQUE,2501,697,747,0,1444,696,743,0,1439
14,JALISCO,16,SAN PEDRO TLAQUEPAQUE,99,SAN PEDRO TLAQUEPAQUE,2502,533,557,0,1090,529,556,0,1085
14,JALISCO,16,SAN PEDRO TLAQUEPAQUE,99,SAN PEDRO TLAQUEPAQUE,2503,579,661,0,1240,577,658,0,1235
14,JALISCO,16,SAN PEDRO TLAQUEPAQUE,99,SAN PEDRO TLAQUEPAQUE,2504,602,672,0,1274,598,667,0,1265
14,JALISCO,16,SAN PEDRO TLAQUEPAQUE,99,SAN PEDRO TLAQUEPAQUE,2505,591,677,0,1268,580,672,0,1252
14,JALISCO,16,SAN PEDRO TLAQUEPAQUE,99,SAN PEDRO TLAQUEPAQUE,2506,753,837,0,1590,748,832,0,1580
14,JALISCO,16,SAN PEDRO TLAQUEPAQUE,99,SAN PEDRO TLAQUEPAQUE,2507,778,882,0,1660,773,878,0,1651
14,JALISCO,16,SAN PEDRO TLAQUEPAQUE,99,SAN PEDRO TLAQUEPAQUE,2508,635,694,0,1329,630,687,0,1317
14,JALISCO,16,SAN PEDRO TLAQUEPAQUE,99,SAN PEDRO TLAQUEPAQUE,2509,655,694,0,1349,648,687,0,1335
14,JALISCO,16,SAN PEDRO TLAQUEPAQUE,99,SAN PEDRO TLAQUEPAQUE,2510,865,951,0,1816,860,945,0,1805
14,JALISCO,16,SAN PEDRO TLAQUEPAQUE,99,SAN PEDRO TLAQUEPAQUE,2511,622,695,0,1317,619,691,0,1310
14,JALISCO,16,SAN PEDRO TLAQUEPAQUE,99,SAN PEDRO TLAQUEPAQUE,2512,827,863,0,1690,821,855,0,1676
14,JALISCO,16,SAN PEDRO TLAQUEPAQUE,99,SAN PEDRO TLAQUEPAQUE,2513,880,976,0,1856,873,968,0,1841
14,JALISCO,16,SAN PEDRO TLAQUEPAQUE,99,SAN PEDRO TLAQUEPAQUE,2514,348,329,0,677,345,325,0,670
14,JALISCO,16,SAN PEDRO TLAQUEPAQUE,99,SAN PEDRO TLAQUEPAQUE,2515,399,415,0,814,395,414,0,809
14,JALISCO,16,SAN PEDRO TLAQUEPAQUE,99,SAN PEDRO TLAQUEPAQUE,2516,479,503,0,982,476,501,0,977
14,JALISCO,16,SAN PEDRO TLAQUEPAQUE,99,SAN PEDRO TLAQUEPAQUE,2517,659,714,0,1373,655,712,0,1367
14,JALISCO,16,SAN PEDRO TLAQUEPAQUE,99,SAN PEDRO TLAQUEPAQUE,2518,687,730,0,1417,680,727,0,1407
14,JALISCO,16,SAN PEDRO TLAQUEPAQUE,99,SAN PEDRO TLAQUEPAQUE,2519,1663,1772,0,3435,1641,1759,0,3400
14,JALISCO,16,SAN PEDRO TLAQUEPAQUE,99,SAN PEDRO TLAQUEPAQUE,2520,968,991,0,1959,960,983,0,1943
14,JALISCO,16,SAN PEDRO TLAQUEPAQUE,99,SAN PEDRO TLAQUEPAQUE,2521,527,559,0,1086,521,555,0,1076
14,JALISCO,16,SAN PEDRO TLAQUEPAQUE,99,SAN PEDRO TLAQUEPAQUE,2522,537,606,1,1144,534,599,1,1134
14,JALISCO,16,SAN PEDRO TLAQUEPAQUE,99,SAN PEDRO TLAQUEPAQUE,2523,2283,2436,0,4719,2271,2420,0,4691
14,JALISCO,16,SAN PEDRO TLAQUEPAQUE,99,SAN PEDRO TLAQUEPAQUE,2524,2283,2491,0,4774,2264,2475,0,4739
14,JALISCO,16,SAN PEDRO TLAQUEPAQUE,99,SAN PEDRO TLAQUEPAQUE,2525,852,933,0,1785,842,930,0,1772
14,JALISCO,16,SAN PEDRO TLAQUEPAQUE,99,SAN PEDRO TLAQUEPAQUE,2526,1458,1540,0,2998,1447,1524,0,2971
14,JALISCO,16,SAN PEDRO TLAQUEPAQUE,99,SAN PEDRO TLAQUEPAQUE,2527,834,802,0,1636,823,795,0,1618
14,JALISCO,16,SAN PEDRO TLAQUEPAQUE,99,SAN PEDRO TLAQUEPAQUE,2528,2038,2081,0,4119,2007,2059,0,4066
14,JALISCO,16,SAN PEDRO TLAQUEPAQUE,99,SAN PEDRO TLAQUEPAQUE,2529,1596,1611,0,3207,1577,1595,0,3172
14,JALISCO,16,SAN PEDRO TLAQUEPAQUE,99,SAN PEDRO TLAQUEPAQUE,2530,2661,2859,0,5520,2639,2832,0,5471
14,JALISCO,16,SAN PEDRO TLAQUEPAQUE,99,SAN PEDRO TLAQUEPAQUE,2531,812,951,0,1763,806,942,0,1748
14,JALISCO,16,SAN PEDRO TLAQUEPAQUE,99,SAN PEDRO TLAQUEPAQUE,2532,1288,1351,0,2639,1280,1338,0,2618
14,JALISCO,16,SAN PEDRO TLAQUEPAQUE,99,SAN PEDRO TLAQUEPAQUE,2533,882,960,0,1842,877,953,0,1830
14,JALISCO,16,SAN PEDRO TLAQUEPAQUE,99,SAN PEDRO TLAQUEPAQUE,2534,861,1023,0,1884,855,1012,0,1867
14,JALISCO,16,SAN PEDRO TLAQUEPAQUE,99,SAN PEDRO TLAQUEPAQUE,2535,667,685,0,1352,664,679,0,1343
14,JALISCO,16,SAN PEDRO TLAQUEPAQUE,99,SAN PEDRO TLAQUEPAQUE,2536,852,916,0,1768,844,911,0,1755
14,JALISCO,16,SAN PEDRO TLAQUEPAQUE,99,SAN PEDRO TLAQUEPAQUE,2537,1713,1783,0,3496,1698,1766,0,3464
14,JALISCO,16,SAN PEDRO TLAQUEPAQUE,99,SAN PEDRO TLAQUEPAQUE,2538,1088,1165,0,2253,1083,1152,0,2235
14,JALISCO,16,SAN PEDRO TLAQUEPAQUE,99,SAN PEDRO TLAQUEPAQUE,2539,1670,1815,0,3485,1653,1795,0,3448
14,JALISCO,16,SAN PEDRO TLAQUEPAQUE,99,SAN PEDRO TLAQUEPAQUE,2540,2430,2630,0,5060,2411,2614,0,5025
14,JALISCO,16,SAN PEDRO TLAQUEPAQUE,99,SAN PEDRO TLAQUEPAQUE,2541,1038,1018,0,2056,1028,1009,0,2037
14,JALISCO,16,SAN PEDRO TLAQUEPAQUE,99,SAN PEDRO TLAQUEPAQUE,2542,1235,1239,0,2474,1225,1228,0,2453
14,JALISCO,16,SAN PEDRO TLAQUEPAQUE,99,SAN PEDRO TLAQUEPAQUE,2543,1298,1320,0,2618,1283,1309,0,2592
14,JALISCO,16,SAN PEDRO TLAQUEPAQUE,99,SAN PEDRO TLAQUEPAQUE,2544,1468,1416,0,2884,1456,1408,0,2864
14,JALISCO,16,SAN PEDRO TLAQUEPAQUE,99,SAN PEDRO TLAQUEPAQUE,2545,1615,1617,0,3232,1604,1606,0,3210
14,JALISCO,16,SAN PEDRO TLAQUEPAQUE,99,SAN PEDRO TLAQUEPAQUE,2546,1242,1338,0,2580,1233,1324,0,2557
14,JALISCO,16,SAN PEDRO TLAQUEPAQUE,99,SAN PEDRO TLAQUEPAQUE,2547,994,1075,0,2069,983,1064,0,2047
14,JALISCO,16,SAN PEDRO TLAQUEPAQUE,99,SAN PEDRO TLAQUEPAQUE,2548,2594,2699,0,5293,2572,2675,0,5247
14,JALISCO,16,SAN PEDRO TLAQUEPAQUE,99,SAN PEDRO TLAQUEPAQUE,2549,1156,1224,0,2380,1145,1214,0,2359
14,JALISCO,16,SAN PEDRO TLAQUEPAQUE,99,SAN PEDRO TLAQUEPAQUE,2550,917,950,0,1867,904,942,0,1846
14,JALISCO,16,SAN PEDRO TLAQUEPAQUE,99,SAN PEDRO TLAQUEPAQUE,2551,757,787,1,1545,750,780,1,1531
14,JALISCO,16,SAN PEDRO TLAQUEPAQUE,99,SAN PEDRO TLAQUEPAQUE,2552,904,970,0,1874,898,964,0,1862
14,JALISCO,16,SAN PEDRO TLAQUEPAQUE,99,SAN PEDRO TLAQUEPAQUE,2553,1164,1150,0,2314,1151,1135,0,2286
14,JALISCO,16,SAN PEDRO TLAQUEPAQUE,99,SAN PEDRO TLAQUEPAQUE,2554,1287,1405,0,2692,1277,1390,0,2667
14,JALISCO,16,SAN PEDRO TLAQUEPAQUE,99,SAN PEDRO TLAQUEPAQUE,2555,851,874,0,1725,838,870,0,1708
14,JALISCO,16,SAN PEDRO TLAQUEPAQUE,99,SAN PEDRO TLAQUEPAQUE,2556,4138,4335,0,8473,4090,4289,0,8379
14,JALISCO,16,SAN PEDRO TLAQUEPAQUE,99,SAN PEDRO TLAQUEPAQUE,2557,1623,1787,0,3410,1610,1770,0,3380
14,JALISCO,16,SAN PEDRO TLAQUEPAQUE,99,SAN PEDRO TLAQUEPAQUE,2558,1138,1185,0,2323,1118,1169,0,2287
14,JALISCO,16,SAN PEDRO TLAQUEPAQUE,99,SAN PEDRO TLAQUEPAQUE,2559,1420,1440,0,2860,1408,1429,0,2837
14,JALISCO,16,SAN PEDRO TLAQUEPAQUE,99,SAN PEDRO TLAQUEPAQUE,2560,895,1004,0,1899,883,995,0,1878
14,JALISCO,16,SAN PEDRO TLAQUEPAQUE,99,SAN PEDRO TLAQUEPAQUE,2561,836,867,0,1703,828,857,0,1685
14,JALISCO,16,SAN PEDRO TLAQUEPAQUE,99,SAN PEDRO TLAQUEPAQUE,2563,4268,4545,0,8813,4218,4500,0,8718
14,JALISCO,16,SAN PEDRO TLAQUEPAQUE,99,SAN PEDRO TLAQUEPAQUE,2565,1808,1977,0,3785,1789,1952,0,3741
14,JALISCO,16,SAN PEDRO TLAQUEPAQUE,99,SAN PEDRO TLAQUEPAQUE,2566,1950,2048,0,3998,1937,2018,0,3955
14,JALISCO,16,SAN PEDRO TLAQUEPAQUE,99,SAN PEDRO TLAQUEPAQUE,2567,4683,4651,0,9334,4645,4622,0,9267
14,JALISCO,16,SAN PEDRO TLAQUEPAQUE,99,SAN PEDRO TLAQUEPAQUE,2568,2575,2798,0,5373,2559,2774,0,5333
14,JALISCO,16,SAN PEDRO TLAQUEPAQUE,99,SAN PEDRO TLAQUEPAQUE,2569,1843,1869,0,3712,1831,1862,0,3693
14,JALISCO,16,SAN PEDRO TLAQUEPAQUE,99,SAN PEDRO TLAQUEPAQUE,2570,836,879,0,1715,826,873,0,1699
14,JALISCO,16,SAN PEDRO TLAQUEPAQUE,99,SAN PEDRO TLAQUEPAQUE,2586,2329,2359,0,4688,2309,2329,0,4638
14,JALISCO,16,SAN PEDRO TLAQUEPAQUE,99,SAN PEDRO TLAQUEPAQUE,2587,4142,4288,0,8430,4093,4254,0,8347
14,JALISCO,16,SAN PEDRO TLAQUEPAQUE,99,SAN PEDRO TLAQUEPAQUE,2588,2360,2346,0,4706,2340,2327,0,4667
14,JALISCO,16,SAN PEDRO TLAQUEPAQUE,99,SAN PEDRO TLAQUEPAQUE,2589,1367,1369,0,2736,1357,1361,0,2718
14,JALISCO,16,SAN PEDRO TLAQUEPAQUE,99,SAN PEDRO TLAQUEPAQUE,2590,1797,1866,0,3663,1781,1848,0,3629
14,JALISCO,16,SAN PEDRO TLAQUEPAQUE,99,SAN PEDRO TLAQUEPAQUE,2591,1303,1329,0,2632,1290,1324,0,2614
14,JALISCO,16,SAN PEDRO TLAQUEPAQUE,99,SAN PEDRO TLAQUEPAQUE,2592,2180,2196,0,4376,2172,2180,0,4352
14,JALISCO,16,SAN PEDRO TLAQUEPAQUE,99,SAN PEDRO TLAQUEPAQUE,2593,1580,1692,0,3272,1570,1689,0,3259
14,JALISCO,16,SAN PEDRO TLAQUEPAQUE,99,SAN PEDRO TLAQUEPAQUE,2607,2090,2178,0,4268,2074,2161,0,4235
14,JALISCO,16,SAN PEDRO TLAQUEPAQUE,99,SAN PEDRO TLAQUEPAQUE,2608,512,505,0,1017,508,499,0,1007
14,JALISCO,16,SAN PEDRO TLAQUEPAQUE,99,SAN PEDRO TLAQUEPAQUE,2609,926,924,0,1850,919,919,0,1838
14,JALISCO,16,SAN PEDRO TLAQUEPAQUE,99,SAN PEDRO TLAQUEPAQUE,2610,655,629,0,1284,649,624,0,1273
14,JALISCO,16,SAN PEDRO TLAQUEPAQUE,99,SAN PEDRO TLAQUEPAQUE,2611,1860,1931,0,3791,1840,1917,0,3757
14,JALISCO,16,SAN PEDRO TLAQUEPAQUE,99,SAN PEDRO TLAQUEPAQUE,2612,573,640,0,1213,572,635,0,1207
14,JALISCO,16,SAN PEDRO TLAQUEPAQUE,99,SAN PEDRO TLAQUEPAQUE,3310,352,368,0,720,350,368,0,718
14,JALISCO,16,SAN PEDRO TLAQUEPAQUE,99,SAN PEDRO TLAQUEPAQUE,3612,1372,1405,0,2777,1361,1395,0,2756
14,JALISCO,16,SAN PEDRO TLAQUEPAQUE,99,SAN PEDRO TLAQUEPAQUE,3613,636,653,0,1289,629,647,0,1276
14,JALISCO,16,SAN PEDRO TLAQUEPAQUE,99,SAN PEDRO TLAQUEPAQUE,3614,1522,1541,0,3063,1511,1529,0,3040
14,JALISCO,16,SAN PEDRO TLAQUEPAQUE,99,SAN PEDRO TLAQUEPAQUE,3615,510,503,0,1013,506,499,0,1005
14,JALISCO,16,SAN PEDRO TLAQUEPAQUE,99,SAN PEDRO TLAQUEPAQUE,3616,1635,1638,0,3273,1618,1627,0,3245
14,JALISCO,16,SAN PEDRO TLAQUEPAQUE,99,SAN PEDRO TLAQUEPAQUE,3617,1266,1264,0,2530,1251,1254,0,2505
14,JALISCO,16,SAN PEDRO TLAQUEPAQUE,99,SAN PEDRO TLAQUEPAQUE,3618,1565,1648,0,3213,1550,1635,0,3185
14,JALISCO,16,SAN PEDRO TLAQUEPAQUE,99,SAN PEDRO TLAQUEPAQUE,3619,1296,1234,0,2530,1286,1224,0,2510
14,JALISCO,16,SAN PEDRO TLAQUEPAQUE,99,SAN PEDRO TLAQUEPAQUE,3620,763,755,0,1518,757,749,0,1506
14,JALISCO,16,SAN PEDRO TLAQUEPAQUE,99,SAN PEDRO TLAQUEPAQUE,3621,1778,1835,0,3613,1764,1823,0,3587
14,JALISCO,16,SAN PEDRO TLAQUEPAQUE,99,SAN PEDRO TLAQUEPAQUE,3736,967,1014,0,1981,961,1010,0,1971
14,JALISCO,16,SAN PEDRO TLAQUEPAQUE,99,SAN PEDRO TLAQUEPAQUE,3737,632,709,0,1341,626,705,0,1331
14,JALISCO,16,SAN PEDRO TLAQUEPAQUE,99,SAN PEDRO TLAQUEPAQUE,3840,1473,1542,0,3015,1462,1529,0,2991
14,JALISCO,16,SAN PEDRO TLAQUEPAQUE,99,SAN PEDRO TLAQUEPAQUE,3841,1484,1610,0,3094,1473,1596,0,3069
14,JALISCO,16,SAN PEDRO TLAQUEPAQUE,99,SAN PEDRO TLAQUEPAQUE,3842,1083,1106,0,2189,1067,1095,0,2162
14,JALISCO,16,SAN PEDRO TLAQUEPAQUE,99,SAN PEDRO TLAQUEPAQUE,3843,680,710,0,1390,673,704,0,1377
14,JALISCO,16,SAN PEDRO TLAQUEPAQUE,99,SAN PEDRO TLAQUEPAQUE,3844,1618,1678,0,3296,1603,1661,0,3264
14,JALISCO,16,SAN PEDRO TLAQUEPAQUE,99,SAN PEDRO TLAQUEPAQUE,3845,725,734,0,1459,719,725,0,1444
14,JALISCO,16,SAN PEDRO TLAQUEPAQUE,99,SAN PEDRO TLAQUEPAQUE,3846,612,642,0,1254,607,634,0,1241
14,JALISCO,16,SAN PEDRO TLAQUEPAQUE,99,SAN PEDRO TLAQUEPAQUE,3847,623,630,0,1253,615,620,0,1235
14,JALISCO,16,SAN PEDRO TLAQUEPAQUE,99,SAN PEDRO TLAQUEPAQUE,3984,727,747,0,1474,721,738,0,1459
14,JALISCO,16,SAN PEDRO TLAQUEPAQUE,99,SAN PEDRO TLAQUEPAQUE,3985,1183,1308,0,2491,1175,1296,0,2471
14,JALISCO,16,SAN PEDRO TLAQUEPAQUE,99,SAN PEDRO TLAQUEPAQUE,3986,1237,1341,0,2578,1227,1337,0,2564
14,JALISCO,16,SAN PEDRO TLAQUEPAQUE,99,SAN PEDRO TLAQUEPAQUE,3987,1021,1100,0,2121,1011,1089,0,2100
14,JALISCO,16,SAN PEDRO TLAQUEPAQUE,99,SAN PEDRO TLAQUEPAQUE,3988,1467,1521,0,2988,1453,1506,0,2959
14,JALISCO,17,JOCOTEPEC,2,ACATLAN DE JUAREZ,13,1265,1244,0,2509,1239,1220,0,2459
14,JALISCO,17,JOCOTEPEC,2,ACATLAN DE JUAREZ,14,558,585,0,1143,551,570,0,1121
14,JALISCO,17,JOCOTEPEC,2,ACATLAN DE JUAREZ,15,893,900,0,1793,884,887,0,1771
14,JALISCO,17,JOCOTEPEC,2,ACATLAN DE JUAREZ,16,999,1100,0,2099,981,1081,0,2062
14,JALISCO,17,JOCOTEPEC,2,ACATLAN DE JUAREZ,17,820,883,0,1703,810,874,0,1684
14,JALISCO,17,JOCOTEPEC,2,ACATLAN DE JUAREZ,18,1598,1583,0,3181,1570,1558,0,3128
14,JALISCO,17,JOCOTEPEC,2,ACATLAN DE JUAREZ,19,595,666,0,1261,587,660,0,1247
14,JALISCO,17,JOCOTEPEC,2,ACATLAN DE JUAREZ,20,488,544,0,1032,482,538,0,1020
14,JALISCO,17,JOCOTEPEC,2,ACATLAN DE JUAREZ,21,453,471,0,924,451,467,0,918
14,JALISCO,17,JOCOTEPEC,2,ACATLAN DE JUAREZ,22,1142,1161,0,2303,1125,1145,0,2270
14,JALISCO,17,JOCOTEPEC,2,ACATLAN DE JUAREZ,23,389,404,0,793,381,401,0,782
14,JALISCO,17,JOCOTEPEC,31,CHAPALA,457,2083,2277,0,4360,2067,2260,0,4327
14,JALISCO,17,JOCOTEPEC,31,CHAPALA,458,1518,1705,0,3223,1499,1686,0,3185
14,JALISCO,17,JOCOTEPEC,31,CHAPALA,459,1527,1691,0,3218,1513,1671,0,3184
14,JALISCO,17,JOCOTEPEC,31,CHAPALA,460,493,602,0,1095,490,595,0,1085
14,JALISCO,17,JOCOTEPEC,31,CHAPALA,461,672,748,0,1420,664,741,0,1405
14,JALISCO,17,JOCOTEPEC,31,CHAPALA,462,993,1117,0,2110,984,1113,0,2097
14,JALISCO,17,JOCOTEPEC,31,CHAPALA,463,1184,1294,0,2478,1179,1287,0,2466
14,JALISCO,17,JOCOTEPEC,31,CHAPALA,464,631,671,0,1302,624,668,0,1292
14,JALISCO,17,JOCOTEPEC,31,CHAPALA,465,303,341,0,644,299,336,0,635
14,JALISCO,17,JOCOTEPEC,31,CHAPALA,466,1401,1501,0,2902,1389,1488,0,2877
14,JALISCO,17,JOCOTEPEC,31,CHAPALA,467,1113,1237,0,2350,1099,1230,0,2329
14,JALISCO,17,JOCOTEPEC,31,CHAPALA,468,939,1057,0,1996,923,1048,0,1971
14,JALISCO,17,JOCOTEPEC,31,CHAPALA,469,794,906,0,1700,781,899,0,1680
14,JALISCO,17,JOCOTEPEC,31,CHAPALA,470,1636,1718,0,3354,1613,1697,0,3310
14,JALISCO,17,JOCOTEPEC,31,CHAPALA,471,582,650,0,1232,579,641,0,1220
14,JALISCO,17,JOCOTEPEC,31,CHAPALA,472,906,921,0,1827,896,911,0,1807
14,JALISCO,17,JOCOTEPEC,31,CHAPALA,473,782,853,0,1635,772,835,0,1607
14,JALISCO,17,JOCOTEPEC,31,CHAPALA,474,935,955,0,1890,917,936,0,1853
14,JALISCO,17,JOCOTEPEC,31,CHAPALA,475,1952,2157,0,4109,1935,2132,0,4067
14,JALISCO,17,JOCOTEPEC,46,IXTLAHUACAN DE LOS MEMBRILLOS,1592,1192,1261,0,2453,1184,1255,0,2439
14,JALISCO,17,JOCOTEPEC,46,IXTLAHUACAN DE LOS MEMBRILLOS,1593,740,797,0,1537,733,787,0,1520
14,JALISCO,17,JOCOTEPEC,46,IXTLAHUACAN DE LOS MEMBRILLOS,1594,1263,1342,0,2605,1237,1320,0,2557
14,JALISCO,17,JOCOTEPEC,46,IXTLAHUACAN DE LOS MEMBRILLOS,1596,1553,1641,0,3194,1522,1608,0,3130
14,JALISCO,17,JOCOTEPEC,46,IXTLAHUACAN DE LOS MEMBRILLOS,1598,569,588,0,1157,567,586,0,1153
14,JALISCO,17,JOCOTEPEC,46,IXTLAHUACAN DE LOS MEMBRILLOS,1599,770,826,0,1596,760,820,0,1580
14,JALISCO,17,JOCOTEPEC,46,IXTLAHUACAN DE LOS MEMBRILLOS,1600,213,179,0,392,211,178,0,389
14,JALISCO,17,JOCOTEPEC,46,IXTLAHUACAN DE LOS MEMBRILLOS,1601,1238,1301,0,2539,1223,1281,0,2504
14,JALISCO,17,JOCOTEPEC,46,IXTLAHUACAN DE LOS MEMBRILLOS,3848,875,1011,0,1886,856,997,0,1853
14,JALISCO,17,JOCOTEPEC,46,IXTLAHUACAN DE LOS MEMBRILLOS,3849,1040,1049,0,2089,1018,1032,0,2050
14,JALISCO,17,JOCOTEPEC,46,IXTLAHUACAN DE LOS MEMBRILLOS,3850,695,683,0,1378,689,675,0,1364
14,JALISCO,17,JOCOTEPEC,46,IXTLAHUACAN DE LOS MEMBRILLOS,3851,744,855,0,1599,726,837,0,1563
14,JALISCO,17,JOCOTEPEC,46,IXTLAHUACAN DE LOS MEMBRILLOS,3852,1059,1219,0,2278,1041,1198,0,2239
14,JALISCO,17,JOCOTEPEC,46,IXTLAHUACAN DE LOS MEMBRILLOS,3853,568,581,0,1149,559,577,0,1136
14,JALISCO,17,JOCOTEPEC,46,IXTLAHUACAN DE LOS MEMBRILLOS,3854,1059,1142,0,2201,1033,1109,0,2142
14,JALISCO,17,JOCOTEPEC,46,IXTLAHUACAN DE LOS MEMBRILLOS,3855,779,791,0,1570,762,777,0,1539
14,JALISCO,17,JOCOTEPEC,46,IXTLAHUACAN DE LOS MEMBRILLOS,3884,935,972,0,1907,922,966,0,1888
14,JALISCO,17,JOCOTEPEC,46,IXTLAHUACAN DE LOS MEMBRILLOS,3885,634,712,0,1346,631,707,0,1338
14,JALISCO,17,JOCOTEPEC,46,IXTLAHUACAN DE LOS MEMBRILLOS,3989,1031,1025,0,2056,1018,1011,0,2029
14,JALISCO,17,JOCOTEPEC,46,IXTLAHUACAN DE LOS MEMBRILLOS,3990,1381,1458,0,2839,1352,1431,0,2783
14,JALISCO,17,JOCOTEPEC,46,IXTLAHUACAN DE LOS MEMBRILLOS,3991,487,498,0,985,476,487,0,963
14,JALISCO,17,JOCOTEPEC,46,IXTLAHUACAN DE LOS MEMBRILLOS,3992,1236,1324,0,2560,1214,1308,0,2522
14,JALISCO,17,JOCOTEPEC,46,IXTLAHUACAN DE LOS MEMBRILLOS,3993,1293,1367,0,2660,1258,1341,0,2599
14,JALISCO,17,JOCOTEPEC,49,JAMAY,3891,8,7,0,15,8,7,0,15
14,JALISCO,17,JOCOTEPEC,52,JOCOTEPEC,1671,1236,1291,0,2527,1219,1273,0,2492
14,JALISCO,17,JOCOTEPEC,52,JOCOTEPEC,1672,948,1025,0,1973,932,1011,0,1943
14,JALISCO,17,JOCOTEPEC,52,JOCOTEPEC,1673,452,476,0,928,444,473,0,917
14,JALISCO,17,JOCOTEPEC,52,JOCOTEPEC,1674,1612,1678,0,3290,1596,1662,0,3258
14,JALISCO,17,JOCOTEPEC,52,JOCOTEPEC,1676,1273,1337,0,2610,1254,1318,0,2572
14,JALISCO,17,JOCOTEPEC,52,JOCOTEPEC,1677,742,767,0,1509,735,760,0,1495
14,JALISCO,17,JOCOTEPEC,52,JOCOTEPEC,1678,1682,1709,0,3391,1665,1694,0,3359
14,JALISCO,17,JOCOTEPEC,52,JOCOTEPEC,1679,192,205,0,397,190,203,0,393
14,JALISCO,17,JOCOTEPEC,52,JOCOTEPEC,1680,350,363,0,713,346,358,0,704
14,JALISCO,17,JOCOTEPEC,52,JOCOTEPEC,1681,1689,1828,0,3517,1676,1810,0,3486
14,JALISCO,17,JOCOTEPEC,52,JOCOTEPEC,1682,1171,1265,0,2436,1159,1258,0,2417
14,JALISCO,17,JOCOTEPEC,52,JOCOTEPEC,1683,773,806,0,1579,763,795,0,1558
14,JALISCO,17,JOCOTEPEC,52,JOCOTEPEC,1684,963,982,0,1945,941,964,0,1905
14,JALISCO,17,JOCOTEPEC,52,JOCOTEPEC,1685,766,761,0,1527,760,754,0,1514
14,JALISCO,17,JOCOTEPEC,52,JOCOTEPEC,1686,1082,1051,0,2133,1069,1030,0,2099
14,JALISCO,17,JOCOTEPEC,52,JOCOTEPEC,1687,666,735,0,1401,654,715,0,1369
14,JALISCO,17,JOCOTEPEC,52,JOCOTEPEC,1688,1097,1191,0,2288,1089,1179,0,2268
14,JALISCO,17,JOCOTEPEC,52,JOCOTEPEC,3660,664,717,0,1381,662,708,0,1370
14,JALISCO,17,JOCOTEPEC,52,JOCOTEPEC,3661,1452,1569,0,3021,1438,1560,0,2998
14,JALISCO,17,JOCOTEPEC,52,JOCOTEPEC,3694,162,147,0,309,161,145,0,306
14,JALISCO,17,JOCOTEPEC,65,OCOTLAN,1844,2286,2380,0,4666,2265,2368,0,4633
14,JALISCO,17,JOCOTEPEC,65,OCOTLAN,1845,633,602,0,1235,629,600,0,1229
14,JALISCO,17,JOCOTEPEC,65,OCOTLAN,1846,673,727,0,1400,668,720,0,1388
14,JALISCO,17,JOCOTEPEC,65,OCOTLAN,1847,1109,1170,0,2279,1093,1160,0,2253
14,JALISCO,17,JOCOTEPEC,65,OCOTLAN,1848,779,845,0,1624,772,837,0,1609
14,JALISCO,17,JOCOTEPEC,65,OCOTLAN,1849,537,593,0,1130,532,589,0,1121
14,JALISCO,17,JOCOTEPEC,65,OCOTLAN,1850,704,795,0,1499,694,792,0,1486
14,JALISCO,17,JOCOTEPEC,65,OCOTLAN,1851,1149,1243,0,2392,1137,1233,0,2370
14,JALISCO,17,JOCOTEPEC,65,OCOTLAN,1852,2313,2637,0,4950,2290,2617,0,4907
14,JALISCO,17,JOCOTEPEC,65,OCOTLAN,1853,614,677,0,1291,609,669,0,1278
14,JALISCO,17,JOCOTEPEC,65,OCOTLAN,1854,656,743,0,1399,653,737,0,1390
14,JALISCO,17,JOCOTEPEC,65,OCOTLAN,1855,559,652,0,1211,553,648,0,1201
14,JALISCO,17,JOCOTEPEC,65,OCOTLAN,1856,575,660,0,1235,573,657,0,1230
14,JALISCO,17,JOCOTEPEC,65,OCOTLAN,1857,774,850,0,1624,766,842,0,1608
14,JALISCO,17,JOCOTEPEC,65,OCOTLAN,1858,949,1017,0,1966,940,1008,0,1948
14,JALISCO,17,JOCOTEPEC,65,OCOTLAN,1859,661,737,0,1398,656,733,0,1389
14,JALISCO,17,JOCOTEPEC,65,OCOTLAN,1860,315,363,0,678,311,359,0,670
14,JALISCO,17,JOCOTEPEC,65,OCOTLAN,1861,386,444,0,830,386,439,0,825
14,JALISCO,17,JOCOTEPEC,65,OCOTLAN,1862,409,483,0,892,402,477,0,879
14,JALISCO,17,JOCOTEPEC,65,OCOTLAN,1863,292,329,0,621,291,326,0,617
14,JALISCO,17,JOCOTEPEC,65,OCOTLAN,1864,513,582,0,1095,510,575,0,1085
14,JALISCO,17,JOCOTEPEC,65,OCOTLAN,1865,556,574,0,1130,552,570,0,1122
14,JALISCO,17,JOCOTEPEC,65,OCOTLAN,1866,1439,1636,0,3075,1430,1626,0,3056
14,JALISCO,17,JOCOTEPEC,65,OCOTLAN,1867,433,497,0,930,430,495,0,925
14,JALISCO,17,JOCOTEPEC,65,OCOTLAN,1868,1914,2089,0,4003,1898,2074,0,3972
14,JALISCO,17,JOCOTEPEC,65,OCOTLAN,1869,386,372,0,758,378,369,0,747
14,JALISCO,17,JOCOTEPEC,65,OCOTLAN,1870,417,458,0,875,412,452,0,864
14,JALISCO,17,JOCOTEPEC,65,OCOTLAN,1871,388,380,0,768,386,374,0,760
14,JALISCO,17,JOCOTEPEC,65,OCOTLAN,1872,658,808,0,1466,655,801,0,1456
14,JALISCO,17,JOCOTEPEC,65,OCOTLAN,1873,788,800,0,1588,782,790,0,1572
14,JALISCO,17,JOCOTEPEC,65,OCOTLAN,1874,744,789,0,1533,740,783,0,1523
14,JALISCO,17,JOCOTEPEC,65,OCOTLAN,1875,2101,2199,0,4300,2084,2184,0,4268
14,JALISCO,17,JOCOTEPEC,65,OCOTLAN,1877,1768,1994,0,3762,1758,1983,0,3741
14,JALISCO,17,JOCOTEPEC,65,OCOTLAN,1878,1510,1568,0,3078,1498,1556,0,3054
14,JALISCO,17,JOCOTEPEC,65,OCOTLAN,1879,1771,1860,0,3631,1761,1843,0,3604
14,JALISCO,17,JOCOTEPEC,65,OCOTLAN,1880,311,321,0,632,305,320,0,625
14,JALISCO,17,JOCOTEPEC,65,OCOTLAN,1881,491,528,0,1019,489,524,0,1013
14,JALISCO,17,JOCOTEPEC,65,OCOTLAN,1882,507,486,0,993,504,482,0,986
14,JALISCO,17,JOCOTEPEC,65,OCOTLAN,1883,527,585,0,1112,519,580,0,1099
14,JALISCO,17,JOCOTEPEC,65,OCOTLAN,1884,392,422,0,814,387,417,0,804
14,JALISCO,17,JOCOTEPEC,65,OCOTLAN,1885,1362,1355,0,2717,1350,1345,0,2695
14,JALISCO,17,JOCOTEPEC,65,OCOTLAN,3835,273,303,0,576,269,300,0,569
14,JALISCO,17,JOCOTEPEC,65,OCOTLAN,3836,1296,1353,0,2649,1290,1345,0,2635
14,JALISCO,17,JOCOTEPEC,65,OCOTLAN,3837,217,232,0,449,213,227,0,440
14,JALISCO,17,JOCOTEPEC,65,OCOTLAN,3838,1342,1466,0,2808,1333,1458,0,2791
14,JALISCO,17,JOCOTEPEC,65,OCOTLAN,3839,589,657,0,1246,580,651,0,1231
14,JALISCO,17,JOCOTEPEC,68,PONCITLAN,1914,360,417,0,777,358,414,0,772
14,JALISCO,17,JOCOTEPEC,68,PONCITLAN,1915,1450,1563,0,3013,1433,1551,0,2984
14,JALISCO,17,JOCOTEPEC,68,PONCITLAN,1916,737,838,0,1575,722,829,0,1551
14,JALISCO,17,JOCOTEPEC,68,PONCITLAN,1917,357,407,0,764,353,405,0,758
14,JALISCO,17,JOCOTEPEC,68,PONCITLAN,1918,849,896,0,1745,843,890,0,1733
14,JALISCO,17,JOCOTEPEC,68,PONCITLAN,1919,934,1049,0,1983,921,1037,0,1958
14,JALISCO,17,JOCOTEPEC,68,PONCITLAN,1920,1295,1372,0,2667,1284,1367,0,2651
14,JALISCO,17,JOCOTEPEC,68,PONCITLAN,1921,799,861,0,1660,792,854,0,1646
14,JALISCO,17,JOCOTEPEC,68,PONCITLAN,1922,526,570,0,1096,521,568,0,1089
14,JALISCO,17,JOCOTEPEC,68,PONCITLAN,1923,1155,1235,0,2390,1144,1221,0,2365
14,JALISCO,17,JOCOTEPEC,68,PONCITLAN,1924,1013,1078,0,2091,1003,1059,0,2062
14,JALISCO,17,JOCOTEPEC,68,PONCITLAN,1925,1507,1639,0,3146,1493,1625,0,3118
14,JALISCO,17,JOCOTEPEC,68,PONCITLAN,1926,1046,1064,0,2110,1035,1055,0,2090
14,JALISCO,17,JOCOTEPEC,68,PONCITLAN,1927,1003,1055,0,2058,994,1043,0,2037
14,JALISCO,17,JOCOTEPEC,68,PONCITLAN,1928,1043,1106,0,2149,1037,1099,0,2136
14,JALISCO,17,JOCOTEPEC,68,PONCITLAN,1929,1188,1284,0,2472,1179,1277,0,2456
14,JALISCO,17,JOCOTEPEC,68,PONCITLAN,1930,498,522,0,1020,495,520,0,1015
14,JALISCO,17,JOCOTEPEC,68,PONCITLAN,1931,2572,3140,0,5712,2542,3083,0,5625
14,JALISCO,17,JOCOTEPEC,68,PONCITLAN,1932,365,424,0,789,356,414,0,770
14,JALISCO,17,JOCOTEPEC,68,PONCITLAN,1933,1013,1083,0,2096,999,1076,0,2075
14,JALISCO,17,JOCOTEPEC,68,PONCITLAN,3682,111,107,0,218,107,106,0,213
14,JALISCO,17,JOCOTEPEC,90,TECHALUTA DE MONTENEGRO,2298,476,526,0,1002,473,524,0,997
14,JALISCO,17,JOCOTEPEC,90,TECHALUTA DE MONTENEGRO,2299,703,744,0,1447,693,735,0,1428
14,JALISCO,17,JOCOTEPEC,90,TECHALUTA DE MONTENEGRO,2300,461,488,0,949,457,482,0,939
14,JALISCO,17,JOCOTEPEC,114,VILLA CORONA,2829,1593,1658,0,3251,1578,1641,0,3219
14,JALISCO,17,JOCOTEPEC,114,VILLA CORONA,2830,1041,1060,0,2101,1037,1047,0,2084
14,JALISCO,17,JOCOTEPEC,114,VILLA CORONA,2831,1080,1055,0,2135,1063,1048,0,2111
14,JALISCO,17,JOCOTEPEC,114,VILLA CORONA,2832,573,668,0,1241,564,653,0,1217
14,JALISCO,17,JOCOTEPEC,114,VILLA CORONA,2833,502,549,0,1051,498,542,0,1040
14,JALISCO,17,JOCOTEPEC,114,VILLA CORONA,2834,669,678,0,1347,644,653,0,1297
14,JALISCO,17,JOCOTEPEC,114,VILLA CORONA,2835,565,588,0,1153,543,569,0,1112
14,JALISCO,17,JOCOTEPEC,114,VILLA CORONA,2836,194,180,0,374,190,176,0,366
14,JALISCO,17,JOCOTEPEC,114,VILLA CORONA,2837,600,595,0,1195,591,586,0,1177
14,JALISCO,17,JOCOTEPEC,114,VILLA CORONA,2838,1027,1083,0,2110,1016,1065,0,2081
14,JALISCO,17,JOCOTEPEC,119,ZACOALCO DE TORRES,2884,987,1077,0,2064,976,1064,0,2040
14,JALISCO,17,JOCOTEPEC,119,ZACOALCO DE TORRES,2885,598,665,0,1263,591,659,0,1250
14,JALISCO,17,JOCOTEPEC,119,ZACOALCO DE TORRES,2886,651,725,0,1376,648,721,0,1369
14,JALISCO,17,JOCOTEPEC,119,ZACOALCO DE TORRES,2887,1304,1374,0,2678,1292,1368,0,2660
14,JALISCO,17,JOCOTEPEC,119,ZACOALCO DE TORRES,2888,706,750,0,1456,700,746,0,1446
14,JALISCO,17,JOCOTEPEC,119,ZACOALCO DE TORRES,2889,1218,1321,0,2539,1205,1308,0,2513
14,JALISCO,17,JOCOTEPEC,119,ZACOALCO DE TORRES,2890,1354,1356,0,2710,1344,1352,0,2696
14,JALISCO,17,JOCOTEPEC,119,ZACOALCO DE TORRES,2891,726,718,0,1444,716,711,0,1427
14,JALISCO,17,JOCOTEPEC,119,ZACOALCO DE TORRES,2892,683,748,0,1431,677,741,0,1418
14,JALISCO,17,JOCOTEPEC,119,ZACOALCO DE TORRES,2893,750,758,0,1508,726,736,0,1462
14,JALISCO,17,JOCOTEPEC,119,ZACOALCO DE TORRES,2894,517,525,0,1042,512,516,0,1028
14,JALISCO,17,JOCOTEPEC,119,ZACOALCO DE TORRES,2895,608,594,0,1202,599,586,0,1185
14,JALISCO,17,JOCOTEPEC,119,ZACOALCO DE TORRES,2896,328,316,0,644,317,304,0,621
14,JALISCO,17,JOCOTEPEC,119,ZACOALCO DE TORRES,2897,617,593,0,1210,601,576,0,1177
14,JALISCO,17,JOCOTEPEC,119,ZACOALCO DE TORRES,2898,828,768,0,1596,813,754,0,1567
14,JALISCO,17,JOCOTEPEC,119,ZACOALCO DE TORRES,2899,583,564,0,1147,580,555,0,1135
14,JALISCO,18,AUTLAN DE NAVARRO,4,AMACUECA,36,458,511,0,969,452,507,0,959
14,JALISCO,18,AUTLAN DE NAVARRO,4,AMACUECA,37,851,919,0,1770,840,910,0,1750
14,JALISCO,18,AUTLAN DE NAVARRO,4,AMACUECA,38,183,165,0,348,182,164,0,346
14,JALISCO,18,AUTLAN DE NAVARRO,4,AMACUECA,39,841,965,0,1806,839,962,0,1801
14,JALISCO,18,AUTLAN DE NAVARRO,10,ATEMAJAC DE BRIZUELA,144,771,811,0,1582,760,805,0,1565
14,JALISCO,18,AUTLAN DE NAVARRO,10,ATEMAJAC DE BRIZUELA,145,936,1055,0,1991,929,1052,0,1981
14,JALISCO,18,AUTLAN DE NAVARRO,10,ATEMAJAC DE BRIZUELA,146,599,647,0,1246,598,646,0,1244
14,JALISCO,18,AUTLAN DE NAVARRO,10,ATEMAJAC DE BRIZUELA,147,105,94,0,199,105,94,0,199
14,JALISCO,18,AUTLAN DE NAVARRO,10,ATEMAJAC DE BRIZUELA,148,258,305,0,563,255,304,0,559
14,JALISCO,18,AUTLAN DE NAVARRO,15,AUTLAN DE NAVARRO,194,1490,1631,0,3121,1475,1614,0,3089
14,JALISCO,18,AUTLAN DE NAVARRO,15,AUTLAN DE NAVARRO,195,1584,1714,0,3298,1566,1699,0,3265
14,JALISCO,18,AUTLAN DE NAVARRO,15,AUTLAN DE NAVARRO,196,434,556,0,990,428,547,0,975
14,JALISCO,18,AUTLAN DE NAVARRO,15,AUTLAN DE NAVARRO,197,1798,1972,0,3770,1784,1956,0,3740
14,JALISCO,18,AUTLAN DE NAVARRO,15,AUTLAN DE NAVARRO,198,507,552,0,1059,504,548,0,1052
14,JALISCO,18,AUTLAN DE NAVARRO,15,AUTLAN DE NAVARRO,199,684,778,0,1462,682,772,0,1454
14,JALISCO,18,AUTLAN DE NAVARRO,15,AUTLAN DE NAVARRO,200,697,684,0,1381,694,680,0,1374
14,JALISCO,18,AUTLAN DE NAVARRO,15,AUTLAN DE NAVARRO,201,1207,1380,0,2587,1200,1366,0,2566
14,JALISCO,18,AUTLAN DE NAVARRO,15,AUTLAN DE NAVARRO,202,1951,2180,0,4131,1930,2162,0,4092
14,JALISCO,18,AUTLAN DE NAVARRO,15,AUTLAN DE NAVARRO,203,700,772,0,1472,691,762,0,1453
14,JALISCO,18,AUTLAN DE NAVARRO,15,AUTLAN DE NAVARRO,204,685,774,0,1459,675,767,0,1442
14,JALISCO,18,AUTLAN DE NAVARRO,15,AUTLAN DE NAVARRO,205,521,650,0,1171,518,643,0,1161
14,JALISCO,18,AUTLAN DE NAVARRO,15,AUTLAN DE NAVARRO,206,674,741,0,1415,667,734,0,1401
14,JALISCO,18,AUTLAN DE NAVARRO,15,AUTLAN DE NAVARRO,207,1578,1696,0,3274,1557,1683,0,3240
14,JALISCO,18,AUTLAN DE NAVARRO,15,AUTLAN DE NAVARRO,208,831,930,0,1761,825,920,0,1745
14,JALISCO,18,AUTLAN DE NAVARRO,15,AUTLAN DE NAVARRO,209,862,1003,0,1865,857,998,0,1855
14,JALISCO,18,AUTLAN DE NAVARRO,15,AUTLAN DE NAVARRO,210,1890,2046,0,3936,1872,2028,0,3900
14,JALISCO,18,AUTLAN DE NAVARRO,15,AUTLAN DE NAVARRO,211,629,699,0,1328,621,697,0,1318
14,JALISCO,18,AUTLAN DE NAVARRO,15,AUTLAN DE NAVARRO,212,2191,2289,0,4480,2168,2266,0,4434
14,JALISCO,18,AUTLAN DE NAVARRO,15,AUTLAN DE NAVARRO,213,471,500,0,971,460,490,0,950
14,JALISCO,18,AUTLAN DE NAVARRO,15,AUTLAN DE NAVARRO,214,690,661,0,1351,680,648,0,1328
14,JALISCO,18,AUTLAN DE NAVARRO,15,AUTLAN DE NAVARRO,215,281,273,0,554,277,269,0,546
14,JALISCO,18,AUTLAN DE NAVARRO,15,AUTLAN DE NAVARRO,216,643,572,0,1215,637,569,0,1206
14,JALISCO,18,AUTLAN DE NAVARRO,15,AUTLAN DE NAVARRO,217,670,662,0,1332,667,658,0,1325
14,JALISCO,18,AUTLAN DE NAVARRO,15,AUTLAN DE NAVARRO,218,615,583,0,1198,606,575,0,1181
14,JALISCO,18,AUTLAN DE NAVARRO,15,AUTLAN DE NAVARRO,219,525,572,0,1097,520,561,0,1081
14,JALISCO,18,AUTLAN DE NAVARRO,15,AUTLAN DE NAVARRO,220,190,225,0,415,186,221,0,407
14,JALISCO,18,AUTLAN DE NAVARRO,15,AUTLAN DE NAVARRO,221,171,164,0,335,169,162,0,331
14,JALISCO,18,AUTLAN DE NAVARRO,15,AUTLAN DE NAVARRO,222,592,580,0,1172,584,571,0,1155
14,JALISCO,18,AUTLAN DE NAVARRO,15,AUTLAN DE NAVARRO,223,602,629,0,1231,595,622,0,1217
14,JALISCO,18,AUTLAN DE NAVARRO,17,AYUTLA,244,1166,1298,0,2464,1146,1277,0,2423
14,JALISCO,18,AUTLAN DE NAVARRO,17,AYUTLA,245,636,710,0,1346,620,686,0,1306
14,JALISCO,18,AUTLAN DE NAVARRO,17,AYUTLA,246,582,577,0,1159,572,566,0,1138
14,JALISCO,18,AUTLAN DE NAVARRO,17,AYUTLA,247,398,449,0,847,393,438,0,831
14,JALISCO,18,AUTLAN DE NAVARRO,17,AYUTLA,248,536,588,0,1124,520,571,0,1091
14,JALISCO,18,AUTLAN DE NAVARRO,17,AYUTLA,249,280,335,0,615,276,329,0,605
14,JALISCO,18,AUTLAN DE NAVARRO,17,AYUTLA,250,391,377,0,768,387,375,0,762
14,JALISCO,18,AUTLAN DE NAVARRO,17,AYUTLA,251,412,426,0,838,404,419,0,823
14,JALISCO,18,AUTLAN DE NAVARRO,17,AYUTLA,252,136,121,0,257,135,121,0,256
14,JALISCO,18,AUTLAN DE NAVARRO,17,AYUTLA,253,336,300,0,636,335,296,0,631
14,JALISCO,18,AUTLAN DE NAVARRO,17,AYUTLA,254,291,263,0,554,287,261,0,548
14,JALISCO,18,AUTLAN DE NAVARRO,17,AYUTLA,255,284,252,0,536,284,252,0,536
14,JALISCO,18,AUTLAN DE NAVARRO,21,CASIMIRO CASTILLO,302,645,723,0,1368,641,720,0,1361
14,JALISCO,18,AUTLAN DE NAVARRO,21,CASIMIRO CASTILLO,303,564,617,0,1181,559,612,0,1171
14,JALISCO,18,AUTLAN DE NAVARRO,21,CASIMIRO CASTILLO,304,672,766,0,1438,666,764,0,1430
14,JALISCO,18,AUTLAN DE NAVARRO,21,CASIMIRO CASTILLO,305,764,791,0,1555,756,786,0,1542
14,JALISCO,18,AUTLAN DE NAVARRO,21,CASIMIRO CASTILLO,306,400,437,0,837,397,437,0,834
14,JALISCO,18,AUTLAN DE NAVARRO,21,CASIMIRO CASTILLO,307,418,495,0,913,414,492,0,906
14,JALISCO,18,AUTLAN DE NAVARRO,21,CASIMIRO CASTILLO,308,597,646,0,1243,593,641,0,1234
14,JALISCO,18,AUTLAN DE NAVARRO,21,CASIMIRO CASTILLO,309,378,370,0,748,375,369,0,744
14,JALISCO,18,AUTLAN DE NAVARRO,21,CASIMIRO CASTILLO,310,742,801,0,1543,736,798,0,1534
14,JALISCO,18,AUTLAN DE NAVARRO,21,CASIMIRO CASTILLO,311,922,898,0,1820,912,889,0,1801
14,JALISCO,18,AUTLAN DE NAVARRO,21,CASIMIRO CASTILLO,312,568,560,0,1128,561,557,0,1118
14,JALISCO,18,AUTLAN DE NAVARRO,21,CASIMIRO CASTILLO,313,407,444,0,851,402,438,0,840
14,JALISCO,18,AUTLAN DE NAVARRO,21,CASIMIRO CASTILLO,314,574,593,0,1167,570,583,0,1153
14,JALISCO,18,AUTLAN DE NAVARRO,21,CASIMIRO CASTILLO,315,266,260,0,526,263,255,0,518
14,JALISCO,18,AUTLAN DE NAVARRO,22,CIHUATLAN,316,1580,1582,0,3162,1547,1549,0,3096
14,JALISCO,18,AUTLAN DE NAVARRO,22,CIHUATLAN,317,680,699,0,1379,664,683,0,1347
14,JALISCO,18,AUTLAN DE NAVARRO,22,CIHUATLAN,318,920,982,0,1902,900,960,0,1860
14,JALISCO,18,AUTLAN DE NAVARRO,22,CIHUATLAN,319,604,643,0,1247,595,633,0,1228
14,JALISCO,18,AUTLAN DE NAVARRO,22,CIHUATLAN,320,632,691,0,1323,616,679,0,1295
14,JALISCO,18,AUTLAN DE NAVARRO,22,CIHUATLAN,321,784,854,0,1638,774,842,0,1616
14,JALISCO,18,AUTLAN DE NAVARRO,22,CIHUATLAN,322,567,551,0,1118,553,540,0,1093
14,JALISCO,18,AUTLAN DE NAVARRO,22,CIHUATLAN,323,452,481,0,933,441,466,0,907
14,JALISCO,18,AUTLAN DE NAVARRO,22,CIHUATLAN,324,209,259,0,468,206,257,0,463
14,JALISCO,18,AUTLAN DE NAVARRO,22,CIHUATLAN,325,1247,1298,0,2545,1226,1275,0,2501
14,JALISCO,18,AUTLAN DE NAVARRO,22,CIHUATLAN,326,417,455,0,872,413,449,0,862
14,JALISCO,18,AUTLAN DE NAVARRO,22,CIHUATLAN,327,1042,1051,0,2093,1027,1037,0,2064
14,JALISCO,18,AUTLAN DE NAVARRO,22,CIHUATLAN,328,1523,1735,0,3258,1510,1711,0,3221
14,JALISCO,18,AUTLAN DE NAVARRO,22,CIHUATLAN,329,157,135,0,292,153,132,0,285
14,JALISCO,18,AUTLAN DE NAVARRO,22,CIHUATLAN,330,925,917,0,1842,916,902,0,1818
14,JALISCO,18,AUTLAN DE NAVARRO,22,CIHUATLAN,331,2054,2124,0,4178,2030,2093,0,4123
14,JALISCO,18,AUTLAN DE NAVARRO,22,CIHUATLAN,332,116,86,0,202,116,84,0,200
14,JALISCO,18,AUTLAN DE NAVARRO,24,SAN GABRIEL,384,847,871,0,1718,842,868,0,1710
14,JALISCO,18,AUTLAN DE NAVARRO,24,SAN GABRIEL,385,764,846,0,1610,760,841,0,1601
14,JALISCO,18,AUTLAN DE NAVARRO,24,SAN GABRIEL,386,610,639,0,1249,609,637,0,1246
14,JALISCO,18,AUTLAN DE NAVARRO,24,SAN GABRIEL,387,714,740,0,1454,703,733,0,1436
14,JALISCO,18,AUTLAN DE NAVARRO,24,SAN GABRIEL,388,760,777,0,1537,758,775,0,1533
14,JALISCO,18,AUTLAN DE NAVARRO,24,SAN GABRIEL,389,534,585,0,1119,533,581,0,1114
14,JALISCO,18,AUTLAN DE NAVARRO,24,SAN GABRIEL,390,121,119,0,240,120,117,0,237
14,JALISCO,18,AUTLAN DE NAVARRO,24,SAN GABRIEL,391,632,675,0,1307,627,672,0,1299
14,JALISCO,18,AUTLAN DE NAVARRO,24,SAN GABRIEL,392,1147,864,0,2011,1131,854,0,1985
14,JALISCO,18,AUTLAN DE NAVARRO,24,SAN GABRIEL,393,634,657,0,1291,619,639,0,1258
14,JALISCO,18,AUTLAN DE NAVARRO,25,COCULA,394,1068,1194,1,2263,1051,1164,1,2216
14,JALISCO,18,AUTLAN DE NAVARRO,25,COCULA,395,849,923,0,1772,838,902,0,1740
14,JALISCO,18,AUTLAN DE NAVARRO,25,COCULA,396,475,526,0,1001,461,518,0,979
14,JALISCO,18,AUTLAN DE NAVARRO,25,COCULA,397,1806,1946,0,3752,1755,1907,0,3662
14,JALISCO,18,AUTLAN DE NAVARRO,25,COCULA,398,842,932,0,1774,826,919,0,1745
14,JALISCO,18,AUTLAN DE NAVARRO,25,COCULA,399,523,573,0,1096,503,550,0,1053
14,JALISCO,18,AUTLAN DE NAVARRO,25,COCULA,400,198,217,0,415,195,212,0,407
14,JALISCO,18,AUTLAN DE NAVARRO,25,COCULA,401,1109,1130,0,2239,1091,1112,0,2203
14,JALISCO,18,AUTLAN DE NAVARRO,25,COCULA,402,621,646,0,1267,608,641,0,1249
14,JALISCO,18,AUTLAN DE NAVARRO,25,COCULA,403,699,695,0,1394,689,675,0,1364
14,JALISCO,18,AUTLAN DE NAVARRO,25,COCULA,404,718,761,0,1479,703,743,0,1446
14,JALISCO,18,AUTLAN DE NAVARRO,25,COCULA,405,578,583,0,1161,566,569,0,1135
14,JALISCO,18,AUTLAN DE NAVARRO,25,COCULA,406,803,805,0,1608,784,784,0,1568
14,JALISCO,18,AUTLAN DE NAVARRO,25,COCULA,407,293,310,0,603,284,297,0,581
14,JALISCO,18,AUTLAN DE NAVARRO,25,COCULA,408,1134,1132,1,2267,1110,1113,1,2224
14,JALISCO,18,AUTLAN DE NAVARRO,25,COCULA,409,485,454,0,939,479,447,0,926
14,JALISCO,18,AUTLAN DE NAVARRO,25,COCULA,410,417,446,0,863,409,431,0,840
14,JALISCO,18,AUTLAN DE NAVARRO,28,CUAUTITLAN DE GARCIA BARRAGAN,432,638,652,0,1290,634,648,0,1282
14,JALISCO,18,AUTLAN DE NAVARRO,28,CUAUTITLAN DE GARCIA BARRAGAN,433,898,934,0,1832,889,928,0,1817
14,JALISCO,18,AUTLAN DE NAVARRO,28,CUAUTITLAN DE GARCIA BARRAGAN,434,880,870,0,1750,878,866,0,1744
14,JALISCO,18,AUTLAN DE NAVARRO,28,CUAUTITLAN DE GARCIA BARRAGAN,435,1272,1295,0,2567,1270,1292,0,2562
14,JALISCO,18,AUTLAN DE NAVARRO,28,CUAUTITLAN DE GARCIA BARRAGAN,436,981,965,0,1946,968,960,0,1928
14,JALISCO,18,AUTLAN DE NAVARRO,28,CUAUTITLAN DE GARCIA BARRAGAN,437,1054,1036,0,2090,1050,1033,0,2083
14,JALISCO,18,AUTLAN DE NAVARRO,28,CUAUTITLAN DE GARCIA BARRAGAN,438,164,140,0,304,163,140,0,303
14,JALISCO,18,AUTLAN DE NAVARRO,28,CUAUTITLAN DE GARCIA BARRAGAN,439,921,903,0,1824,912,890,0,1802
14,JALISCO,18,AUTLAN DE NAVARRO,28,CUAUTITLAN DE GARCIA BARRAGAN,440,181,180,0,361,178,178,0,356
14,JALISCO,18,AUTLAN DE NAVARRO,33,CHIQUILISTLAN,479,877,930,0,1807,861,909,0,1770
14,JALISCO,18,AUTLAN DE NAVARRO,33,CHIQUILISTLAN,480,1169,1268,0,2437,1136,1230,0,2366
14,JALISCO,18,AUTLAN DE NAVARRO,33,CHIQUILISTLAN,481,205,204,0,409,204,204,0,408
14,JALISCO,18,AUTLAN DE NAVARRO,33,CHIQUILISTLAN,482,235,246,0,481,230,237,0,467
14,JALISCO,18,AUTLAN DE NAVARRO,35,EJUTLA,499,980,945,0,1925,949,913,0,1862
14,JALISCO,18,AUTLAN DE NAVARRO,35,EJUTLA,500,180,154,0,334,180,154,0,334
14,JALISCO,18,AUTLAN DE NAVARRO,39,EL GRULLO,549,1682,1923,0,3605,1663,1899,0,3562
14,JALISCO,18,AUTLAN DE NAVARRO,39,EL GRULLO,550,1047,1165,0,2212,1033,1152,0,2185
14,JALISCO,18,AUTLAN DE NAVARRO,39,EL GRULLO,551,576,682,0,1258,567,672,0,1239
14,JALISCO,18,AUTLAN DE NAVARRO,39,EL GRULLO,552,1058,1105,0,2163,1048,1094,0,2142
14,JALISCO,18,AUTLAN DE NAVARRO,39,EL GRULLO,553,1579,1627,0,3206,1551,1611,0,3162
14,JALISCO,18,AUTLAN DE NAVARRO,39,EL GRULLO,554,585,706,0,1291,580,690,0,1270
14,JALISCO,18,AUTLAN DE NAVARRO,39,EL GRULLO,555,969,1111,0,2080,962,1103,0,2065
14,JALISCO,18,AUTLAN DE NAVARRO,39,EL GRULLO,556,500,569,0,1069,492,560,0,1052
14,JALISCO,18,AUTLAN DE NAVARRO,39,EL GRULLO,557,390,442,0,832,387,437,0,824
14,JALISCO,18,AUTLAN DE NAVARRO,39,EL GRULLO,558,950,1025,0,1975,943,1012,0,1955
14,JALISCO,18,AUTLAN DE NAVARRO,39,EL GRULLO,559,737,802,0,1539,731,796,0,1527
14,JALISCO,18,AUTLAN DE NAVARRO,39,EL GRULLO,560,179,196,0,375,176,194,0,370
14,JALISCO,18,AUTLAN DE NAVARRO,45,LA HUERTA,1573,892,905,0,1797,860,880,0,1740
14,JALISCO,18,AUTLAN DE NAVARRO,45,LA HUERTA,1574,735,776,0,1511,718,754,0,1472
14,JALISCO,18,AUTLAN DE NAVARRO,45,LA HUERTA,1575,467,456,0,923,460,450,0,910
14,JALISCO,18,AUTLAN DE NAVARRO,45,LA HUERTA,1576,357,376,0,733,344,361,0,705
14,JALISCO,18,AUTLAN DE NAVARRO,45,LA HUERTA,1577,418,428,0,846,401,415,0,816
14,JALISCO,18,AUTLAN DE NAVARRO,45,LA HUERTA,1578,547,608,0,1155,530,591,0,1121
14,JALISCO,18,AUTLAN DE NAVARRO,45,LA HUERTA,1579,194,147,0,341,187,145,0,332
14,JALISCO,18,AUTLAN DE NAVARRO,45,LA HUERTA,1580,247,212,0,459,244,207,0,451
14,JALISCO,18,AUTLAN DE NAVARRO,45,LA HUERTA,1581,235,202,0,437,229,199,0,428
14,JALISCO,18,AUTLAN DE NAVARRO,45,LA HUERTA,1582,725,785,0,1510,712,765,0,1477
14,JALISCO,18,AUTLAN DE NAVARRO,45,LA HUERTA,1583,131,130,0,261,126,126,0,252
14,JALISCO,18,AUTLAN DE NAVARRO,45,LA HUERTA,1584,313,280,0,593,306,274,0,580
14,JALISCO,18,AUTLAN DE NAVARRO,45,LA HUERTA,1585,744,678,0,1422,738,675,0,1413
14,JALISCO,18,AUTLAN DE NAVARRO,45,LA HUERTA,1586,386,443,0,829,385,443,0,828
14,JALISCO,18,AUTLAN DE NAVARRO,45,LA HUERTA,1587,896,875,0,1771,894,869,0,1763
14,JALISCO,18,AUTLAN DE NAVARRO,45,LA HUERTA,1588,670,695,0,1365,661,686,0,1347
14,JALISCO,18,AUTLAN DE NAVARRO,45,LA HUERTA,1589,864,808,0,1672,855,792,0,1647
14,JALISCO,18,AUTLAN DE NAVARRO,45,LA HUERTA,1590,744,775,0,1519,740,769,0,1509
14,JALISCO,18,AUTLAN DE NAVARRO,45,LA HUERTA,3683,65,74,0,139,64,68,0,132
14,JALISCO,18,AUTLAN DE NAVARRO,54,JUCHITLAN,1696,736,784,0,1520,711,758,0,1469
14,JALISCO,18,AUTLAN DE NAVARRO,54,JUCHITLAN,1697,652,723,0,1375,632,703,0,1335
14,JALISCO,18,AUTLAN DE NAVARRO,54,JUCHITLAN,1698,572,619,0,1191,553,604,0,1157
14,JALISCO,18,AUTLAN DE NAVARRO,54,JUCHITLAN,1699,338,347,0,685,326,339,0,665
14,JALISCO,18,AUTLAN DE NAVARRO,54,JUCHITLAN,1700,395,448,0,843,388,439,0,827
14,JALISCO,18,AUTLAN DE NAVARRO,54,JUCHITLAN,1701,148,131,0,279,147,130,0,277
14,JALISCO,18,AUTLAN DE NAVARRO,56,EL LIMON,1776,357,370,0,727,350,359,0,709
14,JALISCO,18,AUTLAN DE NAVARRO,56,EL LIMON,1777,560,584,0,1144,547,566,0,1113
14,JALISCO,18,AUTLAN DE NAVARRO,56,EL LIMON,1778,792,794,0,1586,775,764,0,1539
14,JALISCO,18,AUTLAN DE NAVARRO,56,EL LIMON,1779,557,605,0,1162,533,582,0,1115
14,JALISCO,18,AUTLAN DE NAVARRO,56,EL LIMON,1780,436,422,0,858,422,408,0,830
14,JALISCO,18,AUTLAN DE NAVARRO,56,EL LIMON,1781,485,487,0,972,469,473,0,942
14,JALISCO,18,AUTLAN DE NAVARRO,70,VILLA PURIFICACION,2003,680,735,0,1415,673,723,0,1396
14,JALISCO,18,AUTLAN DE NAVARRO,70,VILLA PURIFICACION,2004,531,521,0,1052,527,519,0,1046
14,JALISCO,18,AUTLAN DE NAVARRO,70,VILLA PURIFICACION,2005,514,549,0,1063,513,542,0,1055
14,JALISCO,18,AUTLAN DE NAVARRO,70,VILLA PURIFICACION,2006,881,940,0,1821,872,932,0,1804
14,JALISCO,18,AUTLAN DE NAVARRO,70,VILLA PURIFICACION,2007,646,575,0,1221,642,572,0,1214
14,JALISCO,18,AUTLAN DE NAVARRO,70,VILLA PURIFICACION,2008,132,112,0,244,132,111,0,243
14,JALISCO,18,AUTLAN DE NAVARRO,70,VILLA PURIFICACION,2009,533,476,0,1009,528,472,0,1000
14,JALISCO,18,AUTLAN DE NAVARRO,70,VILLA PURIFICACION,2010,645,600,0,1245,642,600,0,1242
14,JALISCO,18,AUTLAN DE NAVARRO,70,VILLA PURIFICACION,2011,408,393,0,801,404,390,0,794
14,JALISCO,18,AUTLAN DE NAVARRO,70,VILLA PURIFICACION,3684,118,110,0,228,118,110,0,228
14,JALISCO,18,AUTLAN DE NAVARRO,79,SAN MARTIN HIDALGO,2115,1003,1131,0,2134,978,1091,0,2069
14,JALISCO,18,AUTLAN DE NAVARRO,79,SAN MARTIN HIDALGO,2116,723,772,0,1495,702,742,0,1444
14,JALISCO,18,AUTLAN DE NAVARRO,79,SAN MARTIN HIDALGO,2117,1090,1194,0,2284,1055,1162,0,2217
14,JALISCO,18,AUTLAN DE NAVARRO,79,SAN MARTIN HIDALGO,2118,1096,1258,0,2354,1070,1224,0,2294
14,JALISCO,18,AUTLAN DE NAVARRO,79,SAN MARTIN HIDALGO,2119,558,592,0,1150,547,588,0,1135
14,JALISCO,18,AUTLAN DE NAVARRO,79,SAN MARTIN HIDALGO,2120,751,789,0,1540,744,779,0,1523
14,JALISCO,18,AUTLAN DE NAVARRO,79,SAN MARTIN HIDALGO,2121,716,694,0,1410,690,671,0,1361
14,JALISCO,18,AUTLAN DE NAVARRO,79,SAN MARTIN HIDALGO,2122,672,723,0,1395,659,706,0,1365
14,JALISCO,18,AUTLAN DE NAVARRO,79,SAN MARTIN HIDALGO,2123,862,840,0,1702,839,817,0,1656
14,JALISCO,18,AUTLAN DE NAVARRO,79,SAN MARTIN HIDALGO,2124,1733,1753,0,3486,1661,1689,0,3350
14,JALISCO,18,AUTLAN DE NAVARRO,79,SAN MARTIN HIDALGO,2125,1195,1220,0,2415,1180,1209,0,2389
14,JALISCO,18,AUTLAN DE NAVARRO,79,SAN MARTIN HIDALGO,2126,606,700,0,1306,592,689,0,1281
14,JALISCO,18,AUTLAN DE NAVARRO,79,SAN MARTIN HIDALGO,2127,436,453,0,889,425,443,0,868
14,JALISCO,18,AUTLAN DE NAVARRO,79,SAN MARTIN HIDALGO,2128,429,400,0,829,424,390,0,814
14,JALISCO,18,AUTLAN DE NAVARRO,79,SAN MARTIN HIDALGO,2129,403,378,0,781,391,374,0,765
14,JALISCO,18,AUTLAN DE NAVARRO,79,SAN MARTIN HIDALGO,2130,748,761,0,1509,730,744,0,1474
14,JALISCO,18,AUTLAN DE NAVARRO,79,SAN MARTIN HIDALGO,2131,283,271,0,554,279,264,0,543
14,JALISCO,18,AUTLAN DE NAVARRO,87,TAPALPA,2260,961,1054,0,2015,951,1048,0,1999
14,JALISCO,18,AUTLAN DE NAVARRO,87,TAPALPA,2261,630,703,0,1333,627,698,0,1325
14,JALISCO,18,AUTLAN DE NAVARRO,87,TAPALPA,2262,693,812,0,1505,690,808,0,1498
14,JALISCO,18,AUTLAN DE NAVARRO,87,TAPALPA,2263,1064,1180,0,2244,1061,1177,0,2238
14,JALISCO,18,AUTLAN DE NAVARRO,87,TAPALPA,2265,945,966,0,1911,941,964,0,1905
14,JALISCO,18,AUTLAN DE NAVARRO,87,TAPALPA,2266,231,247,0,478,231,247,0,478
14,JALISCO,18,AUTLAN DE NAVARRO,87,TAPALPA,2267,1313,1304,0,2617,1307,1301,0,2608
14,JALISCO,18,AUTLAN DE NAVARRO,87,TAPALPA,2268,259,278,0,537,253,278,0,531
14,JALISCO,18,AUTLAN DE NAVARRO,87,TAPALPA,3689,301,296,0,597,299,295,0,594
14,JALISCO,18,AUTLAN DE NAVARRO,87,TAPALPA,3886,1439,1458,0,2897,1434,1452,0,2886
14,JALISCO,18,AUTLAN DE NAVARRO,87,TAPALPA,3887,216,254,0,470,216,254,0,470
14,JALISCO,18,AUTLAN DE NAVARRO,89,TECOLOTLAN,2285,1303,1340,0,2643,1270,1307,0,2577
14,JALISCO,18,AUTLAN DE NAVARRO,89,TECOLOTLAN,2286,456,512,0,968,445,493,0,938
14,JALISCO,18,AUTLAN DE NAVARRO,89,TECOLOTLAN,2287,573,592,0,1165,560,583,0,1143
14,JALISCO,18,AUTLAN DE NAVARRO,89,TECOLOTLAN,2288,1396,1490,0,2886,1361,1462,0,2823
14,JALISCO,18,AUTLAN DE NAVARRO,89,TECOLOTLAN,2289,531,543,0,1074,527,533,0,1060
14,JALISCO,18,AUTLAN DE NAVARRO,89,TECOLOTLAN,2290,387,387,0,774,383,379,0,762
14,JALISCO,18,AUTLAN DE NAVARRO,89,TECOLOTLAN,2291,173,154,0,327,170,153,0,323
14,JALISCO,18,AUTLAN DE NAVARRO,89,TECOLOTLAN,2292,498,483,0,981,486,474,0,960
14,JALISCO,18,AUTLAN DE NAVARRO,89,TECOLOTLAN,2293,565,519,0,1084,546,507,0,1053
14,JALISCO,18,AUTLAN DE NAVARRO,89,TECOLOTLAN,2294,624,656,0,1280,602,640,0,1242
14,JALISCO,18,AUTLAN DE NAVARRO,89,TECOLOTLAN,2295,185,183,0,368,179,180,0,359
14,JALISCO,18,AUTLAN DE NAVARRO,89,TECOLOTLAN,2296,799,825,0,1624,774,800,0,1574
14,JALISCO,18,AUTLAN DE NAVARRO,89,TECOLOTLAN,2297,196,178,0,374,189,177,0,366
14,JALISCO,18,AUTLAN DE NAVARRO,91,TENAMAXTLAN,2301,959,1056,0,2015,928,1028,0,1956
14,JALISCO,18,AUTLAN DE NAVARRO,91,TENAMAXTLAN,2302,1022,1043,0,2065,996,1017,0,2013
14,JALISCO,18,AUTLAN DE NAVARRO,91,TENAMAXTLAN,2303,513,542,0,1055,502,526,0,1028
14,JALISCO,18,AUTLAN DE NAVARRO,91,TENAMAXTLAN,2304,478,483,0,961,456,466,0,922
14,JALISCO,18,AUTLAN DE NAVARRO,91,TENAMAXTLAN,2305,121,118,0,239,113,113,0,226
14,JALISCO,18,AUTLAN DE NAVARRO,91,TENAMAXTLAN,2306,597,543,0,1140,574,533,0,1107
14,JALISCO,18,AUTLAN DE NAVARRO,100,TOLIMAN,2625,554,570,0,1124,539,560,0,1099
14,JALISCO,18,AUTLAN DE NAVARRO,100,TOLIMAN,2626,700,612,0,1312,689,597,0,1286
14,JALISCO,18,AUTLAN DE NAVARRO,100,TOLIMAN,2627,369,352,0,721,358,345,0,703
14,JALISCO,18,AUTLAN DE NAVARRO,100,TOLIMAN,2628,436,407,0,843,425,400,0,825
14,JALISCO,18,AUTLAN DE NAVARRO,100,TOLIMAN,2629,962,1011,0,1973,944,996,0,1940
14,JALISCO,18,AUTLAN DE NAVARRO,100,TOLIMAN,2630,614,668,0,1282,602,658,0,1260
14,JALISCO,18,AUTLAN DE NAVARRO,100,TOLIMAN,2631,568,614,0,1182,558,599,0,1157
14,JALISCO,18,AUTLAN DE NAVARRO,103,TONAYA,2730,748,834,0,1582,731,828,0,1559
14,JALISCO,18,AUTLAN DE NAVARRO,103,TONAYA,2731,631,693,0,1324,622,674,0,1296
14,JALISCO,18,AUTLAN DE NAVARRO,103,TONAYA,2732,618,706,0,1324,607,685,0,1292
14,JALISCO,18,AUTLAN DE NAVARRO,103,TONAYA,2733,356,397,0,753,347,387,0,734
14,JALISCO,18,AUTLAN DE NAVARRO,103,TONAYA,2734,475,472,0,947,470,466,0,936
14,JALISCO,18,AUTLAN DE NAVARRO,107,TUXCACUESCO,2762,807,861,0,1668,781,832,0,1613
14,JALISCO,18,AUTLAN DE NAVARRO,107,TUXCACUESCO,2763,140,128,0,268,136,125,0,261
14,JALISCO,18,AUTLAN DE NAVARRO,107,TUXCACUESCO,2764,791,591,0,1382,773,580,0,1353
14,JALISCO,18,AUTLAN DE NAVARRO,107,TUXCACUESCO,2765,194,179,0,373,189,174,0,363
14,JALISCO,18,AUTLAN DE NAVARRO,107,TUXCACUESCO,2766,526,529,0,1055,516,519,0,1035
14,JALISCO,18,AUTLAN DE NAVARRO,111,UNION DE TULA,2804,1147,1258,0,2405,1138,1251,0,2389
14,JALISCO,18,AUTLAN DE NAVARRO,111,UNION DE TULA,2805,887,971,0,1858,871,960,0,1831
14,JALISCO,18,AUTLAN DE NAVARRO,111,UNION DE TULA,2806,334,428,0,762,324,416,0,740
14,JALISCO,18,AUTLAN DE NAVARRO,111,UNION DE TULA,2807,259,314,0,573,257,309,0,566
14,JALISCO,18,AUTLAN DE NAVARRO,111,UNION DE TULA,2808,485,591,0,1076,480,583,0,1063
14,JALISCO,18,AUTLAN DE NAVARRO,111,UNION DE TULA,2809,590,611,0,1201,573,604,0,1177
14,JALISCO,18,AUTLAN DE NAVARRO,111,UNION DE TULA,2810,500,548,0,1048,497,546,0,1043
14,JALISCO,18,AUTLAN DE NAVARRO,111,UNION DE TULA,2811,471,526,0,997,465,521,0,986
14,JALISCO,18,AUTLAN DE NAVARRO,111,UNION DE TULA,2812,413,388,0,801,405,382,0,787
14,JALISCO,18,AUTLAN DE NAVARRO,111,UNION DE TULA,2813,377,337,0,714,371,330,0,701
14,JALISCO,18,AUTLAN DE NAVARRO,111,UNION DE TULA,2814,327,327,0,654,321,324,0,645
14,JALISCO,18,AUTLAN DE NAVARRO,111,UNION DE TULA,2815,188,194,0,382,187,193,0,380
14,JALISCO,18,AUTLAN DE NAVARRO,111,UNION DE TULA,3686,250,290,0,540,249,288,0,537
14,JALISCO,18,AUTLAN DE NAVARRO,111,UNION DE TULA,3687,60,52,0,112,60,52,0,112
14,JALISCO,18,AUTLAN DE NAVARRO,122,ZAPOTITLAN DE VADILLO,3259,893,970,0,1863,878,957,0,1835
14,JALISCO,18,AUTLAN DE NAVARRO,122,ZAPOTITLAN DE VADILLO,3260,631,681,0,1312,618,667,0,1285
14,JALISCO,18,AUTLAN DE NAVARRO,122,ZAPOTITLAN DE VADILLO,3261,328,332,0,660,323,325,0,648
14,JALISCO,18,AUTLAN DE NAVARRO,122,ZAPOTITLAN DE VADILLO,3262,356,365,0,721,352,358,0,710
14,JALISCO,18,AUTLAN DE NAVARRO,122,ZAPOTITLAN DE VADILLO,3263,386,414,0,800,384,411,0,795
14,JALISCO,18,AUTLAN DE NAVARRO,122,ZAPOTITLAN DE VADILLO,3264,74,60,0,134,72,59,0,131
14,JALISCO,19,ZAPOTLAN EL GRANDE,14,ATOYAC,188,1169,1199,0,2368,1145,1168,0,2313
14,JALISCO,19,ZAPOTLAN EL GRANDE,14,ATOYAC,189,796,818,0,1614,775,797,0,1572
14,JALISCO,19,ZAPOTLAN EL GRANDE,14,ATOYAC,190,529,568,0,1097,513,561,0,1074
14,JALISCO,19,ZAPOTLAN EL GRANDE,14,ATOYAC,191,302,332,0,634,298,325,0,623
14,JALISCO,19,ZAPOTLAN EL GRANDE,14,ATOYAC,192,446,476,0,922,434,468,0,902
14,JALISCO,19,ZAPOTLAN EL GRANDE,14,ATOYAC,193,488,507,0,995,483,499,0,982
14,JALISCO,19,ZAPOTLAN EL GRANDE,23,ZAPOTLAN EL GRANDE,333,3032,3305,0,6337,2990,3255,0,6245
14,JALISCO,19,ZAPOTLAN EL GRANDE,23,ZAPOTLAN EL GRANDE,334,802,953,0,1755,798,944,0,1742
14,JALISCO,19,ZAPOTLAN EL GRANDE,23,ZAPOTLAN EL GRANDE,335,1088,1149,1,2238,1079,1141,1,2221
14,JALISCO,19,ZAPOTLAN EL GRANDE,23,ZAPOTLAN EL GRANDE,336,1069,1169,0,2238,1058,1156,0,2214
14,JALISCO,19,ZAPOTLAN EL GRANDE,23,ZAPOTLAN EL GRANDE,337,425,526,0,951,421,519,0,940
14,JALISCO,19,ZAPOTLAN EL GRANDE,23,ZAPOTLAN EL GRANDE,338,737,798,0,1535,729,786,0,1515
14,JALISCO,19,ZAPOTLAN EL GRANDE,23,ZAPOTLAN EL GRANDE,339,384,416,0,800,377,411,0,788
14,JALISCO,19,ZAPOTLAN EL GRANDE,23,ZAPOTLAN EL GRANDE,340,509,594,0,1103,505,588,0,1093
14,JALISCO,19,ZAPOTLAN EL GRANDE,23,ZAPOTLAN EL GRANDE,341,445,503,0,948,440,491,0,931
14,JALISCO,19,ZAPOTLAN EL GRANDE,23,ZAPOTLAN EL GRANDE,342,1331,1456,0,2787,1312,1431,0,2743
14,JALISCO,19,ZAPOTLAN EL GRANDE,23,ZAPOTLAN EL GRANDE,343,337,356,0,693,333,352,0,685
14,JALISCO,19,ZAPOTLAN EL GRANDE,23,ZAPOTLAN EL GRANDE,344,276,292,0,568,273,291,0,564
14,JALISCO,19,ZAPOTLAN EL GRANDE,23,ZAPOTLAN EL GRANDE,345,447,496,0,943,439,490,0,929
14,JALISCO,19,ZAPOTLAN EL GRANDE,23,ZAPOTLAN EL GRANDE,346,278,345,0,623,275,344,0,619
14,JALISCO,19,ZAPOTLAN EL GRANDE,23,ZAPOTLAN EL GRANDE,347,493,492,0,985,489,490,0,979
14,JALISCO,19,ZAPOTLAN EL GRANDE,23,ZAPOTLAN EL GRANDE,348,563,656,0,1219,559,650,0,1209
14,JALISCO,19,ZAPOTLAN EL GRANDE,23,ZAPOTLAN EL GRANDE,349,654,707,0,1361,646,700,0,1346
14,JALISCO,19,ZAPOTLAN EL GRANDE,23,ZAPOTLAN EL GRANDE,350,238,266,0,504,236,265,0,501
14,JALISCO,19,ZAPOTLAN EL GRANDE,23,ZAPOTLAN EL GRANDE,351,499,535,0,1034,496,531,0,1027
14,JALISCO,19,ZAPOTLAN EL GRANDE,23,ZAPOTLAN EL GRANDE,352,431,477,0,908,427,470,0,897
14,JALISCO,19,ZAPOTLAN EL GRANDE,23,ZAPOTLAN EL GRANDE,353,311,366,0,677,307,362,0,669
14,JALISCO,19,ZAPOTLAN EL GRANDE,23,ZAPOTLAN EL GRANDE,354,1004,1162,0,2166,992,1149,0,2141
14,JALISCO,19,ZAPOTLAN EL GRANDE,23,ZAPOTLAN EL GRANDE,355,601,663,0,1264,593,659,0,1252
14,JALISCO,19,ZAPOTLAN EL GRANDE,23,ZAPOTLAN EL GRANDE,356,1169,1314,0,2483,1156,1304,0,2460
14,JALISCO,19,ZAPOTLAN EL GRANDE,23,ZAPOTLAN EL GRANDE,357,1687,1782,0,3469,1673,1770,0,3443
14,JALISCO,19,ZAPOTLAN EL GRANDE,23,ZAPOTLAN EL GRANDE,358,561,655,0,1216,555,648,0,1203
14,JALISCO,19,ZAPOTLAN EL GRANDE,23,ZAPOTLAN EL GRANDE,359,420,490,0,910,415,487,0,902
14,JALISCO,19,ZAPOTLAN EL GRANDE,23,ZAPOTLAN EL GRANDE,360,660,731,0,1391,657,723,0,1380
14,JALISCO,19,ZAPOTLAN EL GRANDE,23,ZAPOTLAN EL GRANDE,361,687,770,0,1457,682,761,0,1443
14,JALISCO,19,ZAPOTLAN EL GRANDE,23,ZAPOTLAN EL GRANDE,362,946,1146,0,2092,939,1132,0,2071
14,JALISCO,19,ZAPOTLAN EL GRANDE,23,ZAPOTLAN EL GRANDE,363,683,805,0,1488,677,799,0,1476
14,JALISCO,19,ZAPOTLAN EL GRANDE,23,ZAPOTLAN EL GRANDE,364,560,636,0,1196,557,622,0,1179
14,JALISCO,19,ZAPOTLAN EL GRANDE,23,ZAPOTLAN EL GRANDE,365,514,561,0,1075,508,554,0,1062
14,JALISCO,19,ZAPOTLAN EL GRANDE,23,ZAPOTLAN EL GRANDE,366,163,223,0,386,160,218,0,378
14,JALISCO,19,ZAPOTLAN EL GRANDE,23,ZAPOTLAN EL GRANDE,367,499,548,0,1047,495,537,0,1032
14,JALISCO,19,ZAPOTLAN EL GRANDE,23,ZAPOTLAN EL GRANDE,368,478,475,0,953,473,464,0,937
14,JALISCO,19,ZAPOTLAN EL GRANDE,23,ZAPOTLAN EL GRANDE,369,1215,1399,0,2614,1203,1385,0,2588
14,JALISCO,19,ZAPOTLAN EL GRANDE,23,ZAPOTLAN EL GRANDE,370,2009,2404,0,4413,1986,2387,0,4373
14,JALISCO,19,ZAPOTLAN EL GRANDE,23,ZAPOTLAN EL GRANDE,371,639,643,0,1282,633,637,0,1270
14,JALISCO,19,ZAPOTLAN EL GRANDE,23,ZAPOTLAN EL GRANDE,372,625,654,0,1279,618,649,0,1267
14,JALISCO,19,ZAPOTLAN EL GRANDE,23,ZAPOTLAN EL GRANDE,373,648,669,0,1317,647,665,0,1312
14,JALISCO,19,ZAPOTLAN EL GRANDE,23,ZAPOTLAN EL GRANDE,374,1074,1175,0,2249,1067,1169,0,2236
14,JALISCO,19,ZAPOTLAN EL GRANDE,23,ZAPOTLAN EL GRANDE,376,893,1008,0,1901,881,996,0,1877
14,JALISCO,19,ZAPOTLAN EL GRANDE,23,ZAPOTLAN EL GRANDE,377,886,1007,0,1893,877,998,0,1875
14,JALISCO,19,ZAPOTLAN EL GRANDE,23,ZAPOTLAN EL GRANDE,378,1973,2121,0,4094,1943,2102,0,4045
14,JALISCO,19,ZAPOTLAN EL GRANDE,23,ZAPOTLAN EL GRANDE,379,630,701,0,1331,624,697,0,1321
14,JALISCO,19,ZAPOTLAN EL GRANDE,23,ZAPOTLAN EL GRANDE,380,1116,1261,0,2377,1105,1251,0,2356
14,JALISCO,19,ZAPOTLAN EL GRANDE,23,ZAPOTLAN EL GRANDE,381,1895,1979,0,3874,1872,1960,0,3832
14,JALISCO,19,ZAPOTLAN EL GRANDE,23,ZAPOTLAN EL GRANDE,382,233,243,0,476,232,243,0,475
14,JALISCO,19,ZAPOTLAN EL GRANDE,23,ZAPOTLAN EL GRANDE,383,613,593,0,1206,604,584,0,1188
14,JALISCO,19,ZAPOTLAN EL GRANDE,23,ZAPOTLAN EL GRANDE,3856,1014,1042,0,2056,1000,1031,0,2031
14,JALISCO,19,ZAPOTLAN EL GRANDE,23,ZAPOTLAN EL GRANDE,3857,1367,1323,0,2690,1352,1304,0,2656
14,JALISCO,19,ZAPOTLAN EL GRANDE,23,ZAPOTLAN EL GRANDE,3858,1043,1025,0,2068,1033,1016,0,2049
14,JALISCO,19,ZAPOTLAN EL GRANDE,23,ZAPOTLAN EL GRANDE,3859,1292,1458,0,2750,1282,1442,0,2724
14,JALISCO,19,ZAPOTLAN EL GRANDE,23,ZAPOTLAN EL GRANDE,3860,653,633,0,1286,644,620,0,1264
14,JALISCO,19,ZAPOTLAN EL GRANDE,27,CONCEPCION DE BUENOS AIRES,427,629,649,0,1278,617,632,0,1249
14,JALISCO,19,ZAPOTLAN EL GRANDE,27,CONCEPCION DE BUENOS AIRES,428,758,782,0,1540,744,765,0,1509
14,JALISCO,19,ZAPOTLAN EL GRANDE,27,CONCEPCION DE BUENOS AIRES,429,1111,1103,0,2214,1087,1075,0,2162
14,JALISCO,19,ZAPOTLAN EL GRANDE,27,CONCEPCION DE BUENOS AIRES,430,68,74,0,142,66,69,0,135
14,JALISCO,19,ZAPOTLAN EL GRANDE,27,CONCEPCION DE BUENOS AIRES,431,324,329,0,653,319,314,0,633
14,JALISCO,19,ZAPOTLAN EL GRANDE,38,GOMEZ FARIAS,541,1583,1650,0,3233,1569,1639,0,3208
14,JALISCO,19,ZAPOTLAN EL GRANDE,38,GOMEZ FARIAS,542,1281,1329,0,2610,1272,1316,0,2588
14,JALISCO,19,ZAPOTLAN EL GRANDE,38,GOMEZ FARIAS,543,643,721,0,1364,633,708,0,1341
14,JALISCO,19,ZAPOTLAN EL GRANDE,38,GOMEZ FARIAS,544,941,1011,0,1952,933,1002,0,1935
14,JALISCO,19,ZAPOTLAN EL GRANDE,38,GOMEZ FARIAS,545,1537,1708,0,3245,1512,1678,0,3190
14,JALISCO,19,ZAPOTLAN EL GRANDE,38,GOMEZ FARIAS,546,379,421,0,800,377,420,0,797
14,JALISCO,19,ZAPOTLAN EL GRANDE,38,GOMEZ FARIAS,547,124,130,0,254,124,127,0,251
14,JALISCO,19,ZAPOTLAN EL GRANDE,38,GOMEZ FARIAS,548,142,129,0,271,141,126,0,267
14,JALISCO,19,ZAPOTLAN EL GRANDE,51,JILOTLAN DE LOS DOLORES,1661,831,892,0,1723,801,859,0,1660
14,JALISCO,19,ZAPOTLAN EL GRANDE,51,JILOTLAN DE LOS DOLORES,1662,207,148,0,355,202,147,0,349
14,JALISCO,19,ZAPOTLAN EL GRANDE,51,JILOTLAN DE LOS DOLORES,1664,186,170,0,356,182,164,0,346
14,JALISCO,19,ZAPOTLAN EL GRANDE,51,JILOTLAN DE LOS DOLORES,1665,331,327,0,658,328,324,0,652
14,JALISCO,19,ZAPOTLAN EL GRANDE,51,JILOTLAN DE LOS DOLORES,1666,677,679,0,1356,670,671,0,1341
14,JALISCO,19,ZAPOTLAN EL GRANDE,51,JILOTLAN DE LOS DOLORES,1667,172,152,0,324,171,150,0,321
14,JALISCO,19,ZAPOTLAN EL GRANDE,51,JILOTLAN DE LOS DOLORES,1668,315,278,0,593,296,262,0,558
14,JALISCO,19,ZAPOTLAN EL GRANDE,51,JILOTLAN DE LOS DOLORES,1669,246,223,0,469,240,215,0,455
14,JALISCO,19,ZAPOTLAN EL GRANDE,51,JILOTLAN DE LOS DOLORES,1670,102,93,0,195,99,88,0,187
14,JALISCO,19,ZAPOTLAN EL GRANDE,58,SANTA MARIA DEL ORO,1792,603,597,0,1200,590,570,0,1160
14,JALISCO,19,ZAPOTLAN EL GRANDE,58,SANTA MARIA DEL ORO,1793,91,82,0,173,89,82,0,171
14,JALISCO,19,ZAPOTLAN EL GRANDE,58,SANTA MARIA DEL ORO,1794,134,112,0,246,134,112,0,246
14,JALISCO,19,ZAPOTLAN EL GRANDE,58,SANTA MARIA DEL ORO,1795,90,79,0,169,89,76,0,165
14,JALISCO,19,ZAPOTLAN EL GRANDE,58,SANTA MARIA DEL ORO,1796,114,110,0,224,113,110,0,223
14,JALISCO,19,ZAPOTLAN EL GRANDE,59,LA MANZANILLA DE LA PAZ,1797,567,655,0,1222,549,629,0,1178
14,JALISCO,19,ZAPOTLAN EL GRANDE,59,LA MANZANILLA DE LA PAZ,1798,453,486,0,939,438,470,0,908
14,JALISCO,19,ZAPOTLAN EL GRANDE,59,LA MANZANILLA DE LA PAZ,1799,346,360,0,706,330,351,0,681
14,JALISCO,19,ZAPOTLAN EL GRANDE,59,LA MANZANILLA DE LA PAZ,1800,269,279,0,548,261,269,0,530
14,JALISCO,19,ZAPOTLAN EL GRANDE,59,LA MANZANILLA DE LA PAZ,1801,227,255,0,482,226,254,0,480
14,JALISCO,19,ZAPOTLAN EL GRANDE,61,MAZAMITLA,1815,1397,1503,0,2900,1387,1490,0,2877
14,JALISCO,19,ZAPOTLAN EL GRANDE,61,MAZAMITLA,1816,1225,1411,0,2636,1219,1404,0,2623
14,JALISCO,19,ZAPOTLAN EL GRANDE,61,MAZAMITLA,1817,815,958,0,1773,809,951,0,1760
14,JALISCO,19,ZAPOTLAN EL GRANDE,61,MAZAMITLA,1818,560,642,0,1202,556,638,0,1194
14,JALISCO,19,ZAPOTLAN EL GRANDE,61,MAZAMITLA,1819,460,459,0,919,458,458,0,916
14,JALISCO,19,ZAPOTLAN EL GRANDE,61,MAZAMITLA,1820,553,585,0,1138,550,583,0,1133
14,JALISCO,19,ZAPOTLAN EL GRANDE,61,MAZAMITLA,1821,389,386,0,775,385,381,0,766
14,JALISCO,19,ZAPOTLAN EL GRANDE,61,MAZAMITLA,1822,129,139,0,268,129,139,0,268
14,JALISCO,19,ZAPOTLAN EL GRANDE,61,MAZAMITLA,1823,417,451,0,868,413,447,0,860
14,JALISCO,19,ZAPOTLAN EL GRANDE,67,PIHUAMO,1901,562,603,0,1165,548,583,0,1131
14,JALISCO,19,ZAPOTLAN EL GRANDE,67,PIHUAMO,1902,490,539,0,1029,475,525,0,1000
14,JALISCO,19,ZAPOTLAN EL GRANDE,67,PIHUAMO,1903,464,491,0,955,453,479,0,932
14,JALISCO,19,ZAPOTLAN EL GRANDE,67,PIHUAMO,1904,541,544,0,1085,536,533,0,1069
14,JALISCO,19,ZAPOTLAN EL GRANDE,67,PIHUAMO,1905,539,537,0,1076,526,526,0,1052
14,JALISCO,19,ZAPOTLAN EL GRANDE,67,PIHUAMO,1906,432,440,0,872,421,433,0,854
14,JALISCO,19,ZAPOTLAN EL GRANDE,67,PIHUAMO,1907,550,534,0,1084,538,519,0,1057
14,JALISCO,19,ZAPOTLAN EL GRANDE,67,PIHUAMO,1908,484,477,0,961,476,474,0,950
14,JALISCO,19,ZAPOTLAN EL GRANDE,67,PIHUAMO,1909,283,237,0,520,269,226,0,495
14,JALISCO,19,ZAPOTLAN EL GRANDE,67,PIHUAMO,1910,125,113,0,238,125,111,0,236
14,JALISCO,19,ZAPOTLAN EL GRANDE,67,PIHUAMO,1912,195,188,0,383,186,180,0,366
14,JALISCO,19,ZAPOTLAN EL GRANDE,67,PIHUAMO,1913,185,150,0,335,177,145,0,322
14,JALISCO,19,ZAPOTLAN EL GRANDE,71,QUITUPAN,2012,445,464,0,909,427,449,0,876
14,JALISCO,19,ZAPOTLAN EL GRANDE,71,QUITUPAN,2013,537,573,0,1110,526,561,0,1087
14,JALISCO,19,ZAPOTLAN EL GRANDE,71,QUITUPAN,2014,273,291,0,564,267,281,0,548
14,JALISCO,19,ZAPOTLAN EL GRANDE,71,QUITUPAN,2015,484,510,0,994,474,504,0,978
14,JALISCO,19,ZAPOTLAN EL GRANDE,71,QUITUPAN,2016,332,335,0,667,325,326,0,651
14,JALISCO,19,ZAPOTLAN EL GRANDE,71,QUITUPAN,2017,291,279,0,570,280,271,0,551
14,JALISCO,19,ZAPOTLAN EL GRANDE,71,QUITUPAN,2018,835,917,0,1752,795,869,0,1664
14,JALISCO,19,ZAPOTLAN EL GRANDE,71,QUITUPAN,2019,408,413,0,821,397,401,0,798
14,JALISCO,19,ZAPOTLAN EL GRANDE,71,QUITUPAN,2020,90,92,0,182,90,90,0,180
14,JALISCO,19,ZAPOTLAN EL GRANDE,71,QUITUPAN,2021,234,221,0,455,231,218,0,449
14,JALISCO,19,ZAPOTLAN EL GRANDE,71,QUITUPAN,2022,93,84,0,177,91,83,0,174
14,JALISCO,19,ZAPOTLAN EL GRANDE,71,QUITUPAN,2023,196,195,0,391,190,187,0,377
14,JALISCO,19,ZAPOTLAN EL GRANDE,71,QUITUPAN,3688,323,330,0,653,320,326,0,646
14,JALISCO,19,ZAPOTLAN EL GRANDE,83,SAYULA,2162,1069,1173,0,2242,1065,1171,0,2236
14,JALISCO,19,ZAPOTLAN EL GRANDE,83,SAYULA,2163,970,1045,0,2015,968,1042,0,2010
14,JALISCO,19,ZAPOTLAN EL GRANDE,83,SAYULA,2164,743,803,0,1546,739,800,0,1539
14,JALISCO,19,ZAPOTLAN EL GRANDE,83,SAYULA,2165,670,736,0,1406,666,732,0,1398
14,JALISCO,19,ZAPOTLAN EL GRANDE,83,SAYULA,2166,728,769,0,1497,725,769,0,1494
14,JALISCO,19,ZAPOTLAN EL GRANDE,83,SAYULA,2168,1145,1230,0,2375,1137,1225,0,2362
14,JALISCO,19,ZAPOTLAN EL GRANDE,83,SAYULA,2169,450,507,0,957,448,504,0,952
14,JALISCO,19,ZAPOTLAN EL GRANDE,83,SAYULA,2170,350,341,0,691,348,340,0,688
14,JALISCO,19,ZAPOTLAN EL GRANDE,83,SAYULA,2171,1036,1181,0,2217,1032,1177,0,2209
14,JALISCO,19,ZAPOTLAN EL GRANDE,83,SAYULA,2172,340,393,0,733,338,392,0,730
14,JALISCO,19,ZAPOTLAN EL GRANDE,83,SAYULA,2173,1256,1347,0,2603,1248,1345,0,2593
14,JALISCO,19,ZAPOTLAN EL GRANDE,83,SAYULA,2174,541,624,0,1165,539,623,0,1162
14,JALISCO,19,ZAPOTLAN EL GRANDE,83,SAYULA,2175,1586,1686,0,3272,1581,1678,0,3259
14,JALISCO,19,ZAPOTLAN EL GRANDE,83,SAYULA,2176,691,730,0,1421,686,727,0,1413
14,JALISCO,19,ZAPOTLAN EL GRANDE,83,SAYULA,2177,738,821,0,1559,735,820,0,1555
14,JALISCO,19,ZAPOTLAN EL GRANDE,83,SAYULA,2178,825,785,0,1610,818,778,0,1596
14,JALISCO,19,ZAPOTLAN EL GRANDE,83,SAYULA,2179,876,913,0,1789,872,912,0,1784
14,JALISCO,19,ZAPOTLAN EL GRANDE,83,SAYULA,2180,207,234,0,441,206,233,0,439
14,JALISCO,19,ZAPOTLAN EL GRANDE,86,TAMAZULA DE GORDIANO,2223,1114,1210,0,2324,1101,1195,0,2296
14,JALISCO,19,ZAPOTLAN EL GRANDE,86,TAMAZULA DE GORDIANO,2224,968,1071,0,2039,959,1062,0,2021
14,JALISCO,19,ZAPOTLAN EL GRANDE,86,TAMAZULA DE GORDIANO,2225,271,309,0,580,269,306,0,575
14,JALISCO,19,ZAPOTLAN EL GRANDE,86,TAMAZULA DE GORDIANO,2226,475,534,0,1009,468,531,0,999
14,JALISCO,19,ZAPOTLAN EL GRANDE,86,TAMAZULA DE GORDIANO,2227,527,532,0,1059,524,528,0,1052
14,JALISCO,19,ZAPOTLAN EL GRANDE,86,TAMAZULA DE GORDIANO,2228,600,659,0,1259,593,655,0,1248
14,JALISCO,19,ZAPOTLAN EL GRANDE,86,TAMAZULA DE GORDIANO,2229,365,403,0,768,359,400,0,759
14,JALISCO,19,ZAPOTLAN EL GRANDE,86,TAMAZULA DE GORDIANO,2230,1221,1293,0,2514,1207,1289,0,2496
14,JALISCO,19,ZAPOTLAN EL GRANDE,86,TAMAZULA DE GORDIANO,2231,292,345,0,637,289,339,0,628
14,JALISCO,19,ZAPOTLAN EL GRANDE,86,TAMAZULA DE GORDIANO,2232,457,506,0,963,453,502,0,955
14,JALISCO,19,ZAPOTLAN EL GRANDE,86,TAMAZULA DE GORDIANO,2233,395,383,0,778,392,377,0,769
14,JALISCO,19,ZAPOTLAN EL GRANDE,86,TAMAZULA DE GORDIANO,2234,853,994,0,1847,844,982,0,1826
14,JALISCO,19,ZAPOTLAN EL GRANDE,86,TAMAZULA DE GORDIANO,2235,308,343,0,651,307,340,0,647
14,JALISCO,19,ZAPOTLAN EL GRANDE,86,TAMAZULA DE GORDIANO,2236,548,596,0,1144,535,587,0,1122
14,JALISCO,19,ZAPOTLAN EL GRANDE,86,TAMAZULA DE GORDIANO,2237,802,832,0,1634,784,819,0,1603
14,JALISCO,19,ZAPOTLAN EL GRANDE,86,TAMAZULA DE GORDIANO,2238,901,951,0,1852,892,941,0,1833
14,JALISCO,19,ZAPOTLAN EL GRANDE,86,TAMAZULA DE GORDIANO,2239,665,692,0,1357,662,687,0,1349
14,JALISCO,19,ZAPOTLAN EL GRANDE,86,TAMAZULA DE GORDIANO,2240,72,62,0,134,72,61,0,133
14,JALISCO,19,ZAPOTLAN EL GRANDE,86,TAMAZULA DE GORDIANO,2241,151,129,0,280,148,129,0,277
14,JALISCO,19,ZAPOTLAN EL GRANDE,86,TAMAZULA DE GORDIANO,2243,369,329,0,698,364,318,0,682
14,JALISCO,19,ZAPOTLAN EL GRANDE,86,TAMAZULA DE GORDIANO,2244,1138,1232,0,2370,1114,1220,0,2334
14,JALISCO,19,ZAPOTLAN EL GRANDE,86,TAMAZULA DE GORDIANO,2246,309,302,0,611,305,300,0,605
14,JALISCO,19,ZAPOTLAN EL GRANDE,86,TAMAZULA DE GORDIANO,2247,759,759,0,1518,752,751,0,1503
14,JALISCO,19,ZAPOTLAN EL GRANDE,86,TAMAZULA DE GORDIANO,2248,493,489,0,982,491,486,0,977
14,JALISCO,19,ZAPOTLAN EL GRANDE,86,TAMAZULA DE GORDIANO,2249,135,134,0,269,134,134,0,268
14,JALISCO,19,ZAPOTLAN EL GRANDE,86,TAMAZULA DE GORDIANO,2251,141,117,0,258,141,117,0,258
14,JALISCO,19,ZAPOTLAN EL GRANDE,86,TAMAZULA DE GORDIANO,2252,293,316,0,609,290,315,0,605
14,JALISCO,19,ZAPOTLAN EL GRANDE,86,TAMAZULA DE GORDIANO,2253,299,308,0,607,294,305,0,599
14,JALISCO,19,ZAPOTLAN EL GRANDE,86,TAMAZULA DE GORDIANO,2254,592,642,0,1234,590,637,0,1227
14,JALISCO,19,ZAPOTLAN EL GRANDE,86,TAMAZULA DE GORDIANO,2255,733,766,0,1499,725,763,0,1488
14,JALISCO,19,ZAPOTLAN EL GRANDE,86,TAMAZULA DE GORDIANO,2256,470,491,0,961,465,481,0,946
14,JALISCO,19,ZAPOTLAN EL GRANDE,86,TAMAZULA DE GORDIANO,2257,775,765,0,1540,768,759,0,1527
14,JALISCO,19,ZAPOTLAN EL GRANDE,86,TAMAZULA DE GORDIANO,2258,94,101,0,195,93,99,0,192
14,JALISCO,19,ZAPOTLAN EL GRANDE,86,TAMAZULA DE GORDIANO,2259,271,278,0,549,270,276,0,546
14,JALISCO,19,ZAPOTLAN EL GRANDE,88,TECALITLAN,2269,345,371,0,716,335,360,0,695
14,JALISCO,19,ZAPOTLAN EL GRANDE,88,TECALITLAN,2270,747,793,0,1540,735,775,0,1510
14,JALISCO,19,ZAPOTLAN EL GRANDE,88,TECALITLAN,2271,480,532,0,1012,476,512,0,988
14,JALISCO,19,ZAPOTLAN EL GRANDE,88,TECALITLAN,2272,356,427,0,783,348,412,0,760
14,JALISCO,19,ZAPOTLAN EL GRANDE,88,TECALITLAN,2273,448,482,0,930,443,471,0,914
14,JALISCO,19,ZAPOTLAN EL GRANDE,88,TECALITLAN,2274,1223,1268,0,2491,1192,1251,0,2443
14,JALISCO,19,ZAPOTLAN EL GRANDE,88,TECALITLAN,2275,771,832,0,1603,756,806,0,1562
14,JALISCO,19,ZAPOTLAN EL GRANDE,88,TECALITLAN,2276,796,834,0,1630,775,815,0,1590
14,JALISCO,19,ZAPOTLAN EL GRANDE,88,TECALITLAN,2277,974,1081,0,2055,955,1060,0,2015
14,JALISCO,19,ZAPOTLAN EL GRANDE,88,TECALITLAN,2278,81,81,0,162,78,78,0,156
14,JALISCO,19,ZAPOTLAN EL GRANDE,88,TECALITLAN,2279,282,301,0,583,272,299,0,571
14,JALISCO,19,ZAPOTLAN EL GRANDE,88,TECALITLAN,2280,100,112,0,212,100,109,0,209
14,JALISCO,19,ZAPOTLAN EL GRANDE,88,TECALITLAN,2281,42,54,0,96,42,54,0,96
14,JALISCO,19,ZAPOTLAN EL GRANDE,88,TECALITLAN,2282,51,47,0,98,49,46,0,95
14,JALISCO,19,ZAPOTLAN EL GRANDE,88,TECALITLAN,2283,85,73,0,158,82,68,0,150
14,JALISCO,19,ZAPOTLAN EL GRANDE,88,TECALITLAN,2284,181,157,0,338,181,157,0,338
14,JALISCO,19,ZAPOTLAN EL GRANDE,93,TEOCUITATLAN DE CORONA,2330,762,780,0,1542,735,757,0,1492
14,JALISCO,19,ZAPOTLAN EL GRANDE,93,TEOCUITATLAN DE CORONA,2331,519,586,0,1105,505,565,0,1070
14,JALISCO,19,ZAPOTLAN EL GRANDE,93,TEOCUITATLAN DE CORONA,2332,508,477,0,985,499,464,0,963
14,JALISCO,19,ZAPOTLAN EL GRANDE,93,TEOCUITATLAN DE CORONA,2333,337,337,0,674,329,328,0,657
14,JALISCO,19,ZAPOTLAN EL GRANDE,93,TEOCUITATLAN DE CORONA,2334,635,700,0,1335,619,684,0,1303
14,JALISCO,19,ZAPOTLAN EL GRANDE,93,TEOCUITATLAN DE CORONA,2335,403,385,0,788,393,371,0,764
14,JALISCO,19,ZAPOTLAN EL GRANDE,93,TEOCUITATLAN DE CORONA,2336,236,274,0,510,228,266,0,494
14,JALISCO,19,ZAPOTLAN EL GRANDE,93,TEOCUITATLAN DE CORONA,2337,523,541,0,1064,500,525,0,1025
14,JALISCO,19,ZAPOTLAN EL GRANDE,93,TEOCUITATLAN DE CORONA,2338,565,567,0,1132,542,551,0,1093
14,JALISCO,19,ZAPOTLAN EL GRANDE,93,TEOCUITATLAN DE CORONA,2339,800,802,0,1602,785,788,0,1573
14,JALISCO,19,ZAPOTLAN EL GRANDE,97,TIZAPAN EL ALTO,2424,1412,1461,0,2873,1391,1435,0,2826
14,JALISCO,19,ZAPOTLAN EL GRANDE,97,TIZAPAN EL ALTO,2425,752,801,0,1553,736,792,0,1528
14,JALISCO,19,ZAPOTLAN EL GRANDE,97,TIZAPAN EL ALTO,2426,594,621,0,1215,585,612,0,1197
14,JALISCO,19,ZAPOTLAN EL GRANDE,97,TIZAPAN EL ALTO,2427,445,486,0,931,437,474,0,911
14,JALISCO,19,ZAPOTLAN EL GRANDE,97,TIZAPAN EL ALTO,2428,441,495,0,936,431,488,0,919
14,JALISCO,19,ZAPOTLAN EL GRANDE,97,TIZAPAN EL ALTO,2429,739,811,0,1550,721,799,0,1520
14,JALISCO,19,ZAPOTLAN EL GRANDE,97,TIZAPAN EL ALTO,2430,519,584,0,1103,516,575,0,1091
14,JALISCO,19,ZAPOTLAN EL GRANDE,97,TIZAPAN EL ALTO,2431,518,589,0,1107,503,580,0,1083
14,JALISCO,19,ZAPOTLAN EL GRANDE,97,TIZAPAN EL ALTO,2432,886,943,0,1829,877,927,0,1804
14,JALISCO,19,ZAPOTLAN EL GRANDE,97,TIZAPAN EL ALTO,2433,405,459,0,864,400,453,0,853
14,JALISCO,19,ZAPOTLAN EL GRANDE,97,TIZAPAN EL ALTO,2434,654,627,0,1281,645,620,0,1265
14,JALISCO,19,ZAPOTLAN EL GRANDE,97,TIZAPAN EL ALTO,2435,1321,1325,0,2646,1302,1302,0,2604
14,JALISCO,19,ZAPOTLAN EL GRANDE,97,TIZAPAN EL ALTO,2436,246,274,0,520,242,269,0,511
14,JALISCO,19,ZAPOTLAN EL GRANDE,97,TIZAPAN EL ALTO,2437,288,278,0,566,285,271,0,556
14,JALISCO,19,ZAPOTLAN EL GRANDE,104,TONILA,2735,270,291,0,561,261,288,0,549
14,JALISCO,19,ZAPOTLAN EL GRANDE,104,TONILA,2736,247,258,0,505,239,252,0,491
14,JALISCO,19,ZAPOTLAN EL GRANDE,104,TONILA,2737,444,449,0,893,431,439,0,870
14,JALISCO,19,ZAPOTLAN EL GRANDE,104,TONILA,2738,410,423,0,833,402,412,0,814
14,JALISCO,19,ZAPOTLAN EL GRANDE,104,TONILA,2739,529,531,0,1060,517,520,0,1037
14,JALISCO,19,ZAPOTLAN EL GRANDE,104,TONILA,2740,1090,1090,0,2180,1049,1060,0,2109
14,JALISCO,19,ZAPOTLAN EL GRANDE,104,TONILA,2741,163,163,0,326,155,155,0,310
14,JALISCO,19,ZAPOTLAN EL GRANDE,108,TUXCUECA,2767,921,964,0,1885,902,933,0,1835
14,JALISCO,19,ZAPOTLAN EL GRANDE,108,TUXCUECA,2768,1022,1099,0,2121,982,1053,0,2035
14,JALISCO,19,ZAPOTLAN EL GRANDE,108,TUXCUECA,2769,748,840,0,1588,720,804,0,1524
14,JALISCO,19,ZAPOTLAN EL GRANDE,108,TUXCUECA,2770,480,499,0,979,464,488,0,952
14,JALISCO,19,ZAPOTLAN EL GRANDE,109,TUXPAN,2771,978,1076,0,2054,976,1070,0,2046
14,JALISCO,19,ZAPOTLAN EL GRANDE,109,TUXPAN,2772,414,437,0,851,410,433,0,843
14,JALISCO,19,ZAPOTLAN EL GRANDE,109,TUXPAN,2773,1065,1171,0,2236,1060,1167,0,2227
14,JALISCO,19,ZAPOTLAN EL GRANDE,109,TUXPAN,2774,814,921,0,1735,807,916,0,1723
14,JALISCO,19,ZAPOTLAN EL GRANDE,109,TUXPAN,2775,484,587,0,1071,481,582,0,1063
14,JALISCO,19,ZAPOTLAN EL GRANDE,109,TUXPAN,2776,185,225,0,410,184,222,0,406
14,JALISCO,19,ZAPOTLAN EL GRANDE,109,TUXPAN,2777,999,1154,0,2153,994,1148,0,2142
14,JALISCO,19,ZAPOTLAN EL GRANDE,109,TUXPAN,2778,736,806,0,1542,732,804,0,1536
14,JALISCO,19,ZAPOTLAN EL GRANDE,109,TUXPAN,2779,564,643,0,1207,563,639,0,1202
14,JALISCO,19,ZAPOTLAN EL GRANDE,109,TUXPAN,2780,522,610,0,1132,521,607,0,1128
14,JALISCO,19,ZAPOTLAN EL GRANDE,109,TUXPAN,2781,499,538,0,1037,498,536,0,1034
14,JALISCO,19,ZAPOTLAN EL GRANDE,109,TUXPAN,2782,1391,1485,0,2876,1384,1476,0,2860
14,JALISCO,19,ZAPOTLAN EL GRANDE,109,TUXPAN,2783,1078,1186,0,2264,1071,1182,0,2253
14,JALISCO,19,ZAPOTLAN EL GRANDE,109,TUXPAN,2784,486,574,0,1060,486,568,0,1054
14,JALISCO,19,ZAPOTLAN EL GRANDE,109,TUXPAN,2785,330,391,0,721,329,388,0,717
14,JALISCO,19,ZAPOTLAN EL GRANDE,109,TUXPAN,2786,1017,1139,0,2156,1010,1132,0,2142
14,JALISCO,19,ZAPOTLAN EL GRANDE,109,TUXPAN,2787,239,242,0,481,239,242,0,481
14,JALISCO,19,ZAPOTLAN EL GRANDE,109,TUXPAN,2788,144,119,0,263,143,119,0,262
14,JALISCO,19,ZAPOTLAN EL GRANDE,109,TUXPAN,2789,373,356,0,729,367,355,0,722
14,JALISCO,19,ZAPOTLAN EL GRANDE,109,TUXPAN,2790,581,636,0,1217,576,634,0,1210
14,JALISCO,19,ZAPOTLAN EL GRANDE,109,TUXPAN,2791,616,599,0,1215,607,589,0,1196
14,JALISCO,19,ZAPOTLAN EL GRANDE,109,TUXPAN,2792,238,232,0,470,235,227,0,462
14,JALISCO,19,ZAPOTLAN EL GRANDE,109,TUXPAN,2793,200,191,0,391,197,186,0,383
14,JALISCO,19,ZAPOTLAN EL GRANDE,113,VALLE DE JUAREZ,2824,401,414,0,815,386,404,0,790
14,JALISCO,19,ZAPOTLAN EL GRANDE,113,VALLE DE JUAREZ,2825,766,829,0,1595,744,800,0,1544
14,JALISCO,19,ZAPOTLAN EL GRANDE,113,VALLE DE JUAREZ,2826,1440,1552,0,2992,1392,1503,0,2895
14,JALISCO,19,ZAPOTLAN EL GRANDE,113,VALLE DE JUAREZ,2827,69,42,0,111,69,42,0,111
14,JALISCO,19,ZAPOTLAN EL GRANDE,113,VALLE DE JUAREZ,2828,377,422,0,799,365,415,0,780
14,JALISCO,19,ZAPOTLAN EL GRANDE,113,VALLE DE JUAREZ,3690,97,95,0,192,95,95,0,190
14,JALISCO,19,ZAPOTLAN EL GRANDE,121,ZAPOTILTIC,3238,1131,1157,0,2288,1123,1145,0,2268
14,JALISCO,19,ZAPOTLAN EL GRANDE,121,ZAPOTILTIC,3239,1425,1487,0,2912,1410,1478,0,2888
14,JALISCO,19,ZAPOTLAN EL GRANDE,121,ZAPOTILTIC,3240,837,798,0,1635,827,792,0,1619
14,JALISCO,19,ZAPOTLAN EL GRANDE,121,ZAPOTILTIC,3241,741,826,0,1567,733,818,0,1551
14,JALISCO,19,ZAPOTLAN EL GRANDE,121,ZAPOTILTIC,3242,387,437,0,824,384,432,0,816
14,JALISCO,19,ZAPOTLAN EL GRANDE,121,ZAPOTILTIC,3243,498,542,0,1040,496,535,0,1031
14,JALISCO,19,ZAPOTLAN EL GRANDE,121,ZAPOTILTIC,3244,685,794,0,1479,681,790,0,1471
14,JALISCO,19,ZAPOTLAN EL GRANDE,121,ZAPOTILTIC,3245,1238,1301,0,2539,1229,1292,0,2521
14,JALISCO,19,ZAPOTLAN EL GRANDE,121,ZAPOTILTIC,3246,346,378,0,724,345,375,0,720
14,JALISCO,19,ZAPOTLAN EL GRANDE,121,ZAPOTILTIC,3247,1034,1076,0,2110,1026,1071,0,2097
14,JALISCO,19,ZAPOTLAN EL GRANDE,121,ZAPOTILTIC,3248,875,941,0,1816,871,938,0,1809
14,JALISCO,19,ZAPOTLAN EL GRANDE,121,ZAPOTILTIC,3249,260,300,0,560,259,299,0,558
14,JALISCO,19,ZAPOTLAN EL GRANDE,121,ZAPOTILTIC,3250,527,558,0,1085,524,554,0,1078
14,JALISCO,19,ZAPOTLAN EL GRANDE,121,ZAPOTILTIC,3251,670,630,0,1300,668,626,0,1294
14,JALISCO,19,ZAPOTLAN EL GRANDE,121,ZAPOTILTIC,3252,954,1007,0,1961,943,1004,0,1947
14,JALISCO,19,ZAPOTLAN EL GRANDE,121,ZAPOTILTIC,3253,82,75,0,157,82,75,0,157
14,JALISCO,19,ZAPOTLAN EL GRANDE,121,ZAPOTILTIC,3254,182,193,0,375,182,191,0,373
14,JALISCO,19,ZAPOTLAN EL GRANDE,121,ZAPOTILTIC,3255,426,483,0,909,420,471,0,891
14,JALISCO,19,ZAPOTLAN EL GRANDE,121,ZAPOTILTIC,3256,816,866,0,1682,806,852,0,1658
14,JALISCO,19,ZAPOTLAN EL GRANDE,121,ZAPOTILTIC,3257,241,282,0,523,241,280,0,521
14,JALISCO,19,ZAPOTLAN EL GRANDE,121,ZAPOTILTIC,3258,219,207,0,426,213,204,0,417
14,JALISCO,20,TONALA,72,EL SALTO,2024,4678,4977,0,9655,4618,4911,0,9529
14,JALISCO,20,TONALA,72,EL SALTO,2025,2176,2292,0,4468,2161,2271,0,4432
14,JALISCO,20,TONALA,72,EL SALTO,2026,553,537,0,1090,548,532,0,1080
14,JALISCO,20,TONALA,72,EL SALTO,2027,1238,1278,0,2516,1226,1271,0,2497
14,JALISCO,20,TONALA,72,EL SALTO,2028,819,813,0,1632,812,804,0,1616
14,JALISCO,20,TONALA,72,EL SALTO,2029,567,608,0,1175,559,604,0,1163
14,JALISCO,20,TONALA,72,EL SALTO,2031,1296,1391,0,2687,1281,1376,0,2657
14,JALISCO,20,TONALA,72,EL SALTO,2032,729,826,0,1555,724,807,0,1531
14,JALISCO,20,TONALA,72,EL SALTO,2033,1053,1110,0,2163,1044,1104,0,2148
14,JALISCO,20,TONALA,72,EL SALTO,2034,992,1130,0,2122,981,1126,0,2107
14,JALISCO,20,TONALA,72,EL SALTO,2036,3373,3740,0,7113,3312,3664,0,6976
14,JALISCO,20,TONALA,72,EL SALTO,2037,1219,1302,0,2521,1210,1290,0,2500
14,JALISCO,20,TONALA,72,EL SALTO,2038,2904,2857,0,5761,2874,2840,0,5714
14,JALISCO,20,TONALA,72,EL SALTO,2039,1668,1725,0,3393,1660,1713,0,3373
14,JALISCO,20,TONALA,72,EL SALTO,2040,2088,2138,0,4226,2071,2116,0,4187
14,JALISCO,20,TONALA,72,EL SALTO,2041,1910,2039,0,3949,1901,2029,0,3930
14,JALISCO,20,TONALA,72,EL SALTO,2042,1013,1070,0,2083,1006,1066,0,2072
14,JALISCO,20,TONALA,72,EL SALTO,2043,5053,5334,0,10387,5006,5284,0,10290
14,JALISCO,20,TONALA,72,EL SALTO,2044,7328,7668,0,14996,7219,7552,0,14771
14,JALISCO,20,TONALA,72,EL SALTO,2045,1341,1348,0,2689,1320,1337,0,2657
14,JALISCO,20,TONALA,72,EL SALTO,2046,1526,1608,0,3134,1505,1583,0,3088
14,JALISCO,20,TONALA,72,EL SALTO,2047,253,285,0,538,249,284,0,533
14,JALISCO,20,TONALA,72,EL SALTO,2048,4304,4616,1,8921,4251,4556,1,8808
14,JALISCO,20,TONALA,72,EL SALTO,2049,7281,7579,0,14860,7221,7521,0,14742
14,JALISCO,20,TONALA,72,EL SALTO,3994,797,818,0,1615,774,788,0,1562
14,JALISCO,20,TONALA,72,EL SALTO,3995,663,697,0,1360,658,688,0,1346
14,JALISCO,20,TONALA,72,EL SALTO,3996,573,598,0,1171,570,594,0,1164
14,JALISCO,20,TONALA,72,EL SALTO,3997,1005,1009,0,2014,997,999,0,1996
14,JALISCO,20,TONALA,72,EL SALTO,3998,1076,1073,0,2149,1057,1057,0,2114
14,JALISCO,20,TONALA,72,EL SALTO,3999,938,1024,0,1962,925,1009,0,1934
14,JALISCO,20,TONALA,72,EL SALTO,4000,1400,1471,0,2871,1374,1441,0,2815
14,JALISCO,20,TONALA,72,EL SALTO,4001,989,970,0,1959,972,946,0,1918
14,JALISCO,20,TONALA,72,EL SALTO,4002,955,1043,0,1998,939,1025,0,1964
14,JALISCO,20,TONALA,72,EL SALTO,4003,1270,1357,0,2627,1245,1331,0,2576
14,JALISCO,20,TONALA,72,EL SALTO,4004,1143,1190,0,2333,1127,1177,0,2304
14,JALISCO,20,TONALA,72,EL SALTO,4005,1283,1321,0,2604,1274,1309,0,2583
14,JALISCO,20,TONALA,72,EL SALTO,4006,1304,1368,0,2672,1291,1359,0,2650
14,JALISCO,20,TONALA,72,EL SALTO,4007,1308,1379,0,2687,1298,1367,0,2665
14,JALISCO,20,TONALA,72,EL SALTO,4008,1246,1340,0,2586,1230,1323,0,2553
14,JALISCO,20,TONALA,99,SAN PEDRO TLAQUEPAQUE,3888,104,114,0,218,103,113,0,216
14,JALISCO,20,TONALA,99,SAN PEDRO TLAQUEPAQUE,3889,120,122,0,242,117,120,0,237
14,JALISCO,20,TONALA,99,SAN PEDRO TLAQUEPAQUE,3890,386,406,0,792,381,397,0,778
14,JALISCO,20,TONALA,102,TONALA,2691,2027,2126,0,4153,2005,2114,0,4119
14,JALISCO,20,TONALA,102,TONALA,2692,864,910,0,1774,853,905,0,1758
14,JALISCO,20,TONALA,102,TONALA,2693,2023,2076,0,4099,2010,2051,0,4061
14,JALISCO,20,TONALA,102,TONALA,2694,836,912,0,1748,826,903,0,1729
14,JALISCO,20,TONALA,102,TONALA,2696,739,722,0,1461,733,721,0,1454
14,JALISCO,20,TONALA,102,TONALA,2712,1684,1721,1,3406,1669,1705,1,3375
14,JALISCO,20,TONALA,102,TONALA,2713,810,882,0,1692,802,874,0,1676
14,JALISCO,20,TONALA,102,TONALA,2716,1844,2049,0,3893,1823,2025,0,3848
14,JALISCO,20,TONALA,102,TONALA,2717,2082,2093,0,4175,2071,2080,0,4151
14,JALISCO,20,TONALA,102,TONALA,2718,1467,1566,0,3033,1458,1547,0,3005
14,JALISCO,20,TONALA,102,TONALA,2719,1426,1503,0,2929,1411,1489,0,2900
14,JALISCO,20,TONALA,102,TONALA,2720,1469,1458,0,2927,1461,1450,0,2911
14,JALISCO,20,TONALA,102,TONALA,2723,2502,2664,0,5166,2471,2645,0,5116
14,JALISCO,20,TONALA,102,TONALA,2724,3947,3886,0,7833,3909,3853,0,7762
14,JALISCO,20,TONALA,102,TONALA,2725,922,953,0,1875,913,937,0,1850
14,JALISCO,20,TONALA,102,TONALA,2726,2476,2585,0,5061,2450,2559,0,5009
14,JALISCO,20,TONALA,102,TONALA,2729,3777,3873,0,7650,3731,3846,0,7577
14,JALISCO,20,TONALA,102,TONALA,3311,1014,1001,0,2015,1003,987,0,1990
14,JALISCO,20,TONALA,102,TONALA,3740,988,994,0,1982,975,989,0,1964
14,JALISCO,20,TONALA,102,TONALA,3741,1031,1125,0,2156,1022,1114,0,2136
14,JALISCO,20,TONALA,102,TONALA,3742,1391,1499,0,2890,1375,1490,0,2865
14,JALISCO,20,TONALA,102,TONALA,3743,998,1064,0,2062,993,1056,0,2049
14,JALISCO,20,TONALA,102,TONALA,3744,1096,1167,0,2263,1082,1160,0,2242
14,JALISCO,20,TONALA,102,TONALA,3745,1088,1191,0,2279,1071,1179,0,2250
14,JALISCO,20,TONALA,102,TONALA,4009,637,654,0,1291,632,647,0,1279
14,JALISCO,20,TONALA,102,TONALA,4010,686,679,0,1365,677,670,0,1347
14,JALISCO,20,TONALA,102,TONALA,4011,629,666,0,1295,624,665,0,1289
14,JALISCO,20,TONALA,102,TONALA,4012,871,892,0,1763,864,884,0,1748
14,JALISCO,20,TONALA,102,TONALA,4013,781,803,0,1584,771,786,0,1557
14,JALISCO,20,TONALA,102,TONALA,4014,647,692,0,1339,637,685,0,1322
14,JALISCO,20,TONALA,102,TONALA,4015,687,684,0,1371,683,681,0,1364
14,JALISCO,20,TONALA,102,TONALA,4016,588,635,0,1223,583,632,0,1215
14,JALISCO,20,TONALA,102,TONALA,4017,683,674,0,1357,678,666,0,1344
14,JALISCO,20,TONALA,102,TONALA,4018,532,538,0,1070,527,532,0,1059
14,JALISCO,20,TONALA,102,TONALA,4019,868,927,0,1795,860,919,0,1779
14,JALISCO,20,TONALA,102,TONALA,4020,815,784,0,1599,803,772,0,1575
14,JALISCO,20,TONALA,102,TONALA,4021,626,618,0,1244,612,612,0,1224
14,JALISCO,20,TONALA,102,TONALA,4022,984,1049,0,2033,978,1042,0,2020
14,JALISCO,20,TONALA,102,TONALA,4023,938,987,0,1925,928,973,0,1901
14,JALISCO,20,TONALA,102,TONALA,4024,1430,1452,0,2882,1417,1445,0,2862
14,JALISCO,20,TONALA,102,TONALA,4025,1373,1492,0,2865,1363,1477,0,2840
14,JALISCO,20,TONALA,102,TONALA,4026,980,1056,0,2036,965,1044,0,2009
14,JALISCO,20,TONALA,102,TONALA,4027,1310,1380,0,2690,1303,1370,0,2673
14,JALISCO,20,TONALA,102,TONALA,4028,818,890,0,1708,803,878,0,1681
